OBJECTID,STATE,COUNTY,TRACT,SUM_POP100,SUM_HU100,SUM_TotPop,SUM_HispPop,SUM_NonHispPop,SUM_NHOneRace,SUM_NH_White,SUM_NH_Black,SUM_NH_AmInd,SUM_NH_Asian,SUM_NH_HawPacI,SUM_NH_Other,SUM_NH_2orMore,SUM_VAP_TotPop,SUM_VAP_HispPo,SUM_VAP_NonHis,SUM_VAP_NHOneR,SUM_VAP_NH_Whi,SUM_VAP_NH_Bla,SUM_VAP_NH_AmI,SUM_VAP_NH_Asi,SUM_VAP_HawPac,SUM_VAP_NH_Oth,SUM_VAP_NH_2or,SUM_TotHousing,SUM_OccHU,SUM_VacantHU,Shapearea,Shapelen
1,48,015,760100,2400,1087,2400,647,1753,1730,1406,308,8,8,0,0,23,1789,428,1361,1349,1126,208,8,7,0,0,12,1087,910,177,1912508363.33837,240542.665642
2,48,015,760200,6032,2430,6032,2037,3995,3922,3139,747,5,26,0,5,73,4364,1263,3101,3057,2484,547,4,20,0,2,44,2430,2121,309,1666558357.24284,266128.354769
3,48,015,760300,7037,2970,7037,1964,5073,5011,4472,473,13,42,0,11,62,5188,1212,3976,3947,3574,322,10,35,0,6,29,2970,2604,366,3926603170.80177,355938.907851
4,48,015,760400,3660,2172,3660,378,3282,3258,3061,172,7,1,0,17,24,2863,215,2648,2633,2494,122,3,1,0,13,15,2172,1501,671,5351475752.0278,356947.330853
5,48,015,760501,4184,1949,4184,450,3734,3682,3389,268,19,5,0,1,52,3332,303,3029,3000,2772,208,15,4,0,1,29,1949,1658,291,3100561695.20634,303462.136681
6,48,015,760502,5104,2318,5104,1165,3939,3902,3190,654,27,28,1,2,37,3752,695,3057,3038,2517,484,17,18,1,1,19,2318,2043,275,2337925778.61822,333539.853945
7,48,039,660100,4523,1666,4523,704,3819,3758,3392,170,15,171,7,3,61,3483,480,3003,2976,2714,118,13,126,5,0,27,1666,1615,51,45427456.911435,37764.431847
8,48,039,660200,5638,2084,5638,1154,4484,4416,3737,338,19,309,0,13,68,4026,734,3292,3254,2766,242,9,230,0,7,38,2084,1927,157,197001967.319552,65709.35233
9,48,039,660300,9536,3554,9536,1883,7653,7555,6226,856,25,434,3,11,98,6676,1194,5482,5435,4535,567,20,304,2,7,47,3554,3287,267,107347729.075825,49218.047724
10,48,039,660400,9119,3475,9119,2062,7057,6878,5039,892,26,900,0,21,179,6499,1309,5190,5114,3822,591,20,667,0,14,76,3475,3286,189,117491177.62117,50398.808686
11,48,039,660500,8987,3291,8987,3481,5506,5407,4387,676,40,292,2,10,99,6598,2285,4313,4262,3530,477,35,211,2,7,51,3291,3043,248,264195004.15859,68361.481694
12,48,039,660601,11893,4438,11893,1659,10234,9922,5381,2341,29,2154,1,16,312,8654,1034,7620,7466,4246,1663,16,1530,1,10,154,4438,4276,162,120825690.708094,44937.588773
13,48,039,660602,26843,9411,26843,5860,20983,20445,7169,7324,54,5826,6,66,538,18369,3582,14787,14565,5373,5117,39,3991,4,41,222,9411,8729,682,514418668.455595,97650.942977
14,48,039,660701,15452,5685,15452,2480,12972,12648,6556,3801,34,2212,1,44,324,10292,1454,8838,8691,4556,2569,20,1524,1,21,147,5685,5340,345,111641609.767835,48941.433836
15,48,039,660702,11664,4338,11664,2222,9442,9246,6142,1635,33,1414,2,20,196,7955,1377,6578,6486,4384,1120,20,952,2,8,92,4338,3997,341,399037682.639826,86559.33028
16,48,039,660801,8422,2906,8422,2476,5946,5829,4141,1191,36,449,6,6,117,5845,1566,4279,4229,3085,790,23,321,5,5,50,2906,2798,108,73931807.718414,42952.080003
17,48,039,660802,7486,2444,7486,1881,5605,5435,4165,998,9,234,4,25,170,5047,1135,3912,3836,2985,653,7,178,3,10,76,2444,2371,73,81841576.446474,46945.69333
18,48,039,660900,6806,2301,6806,3609,3197,3150,2728,210,23,165,3,21,47,4767,2284,2483,2454,2133,152,18,132,3,16,29,2301,2065,236,484483256.500466,94545.740878
19,48,039,661000,6432,2327,6432,2450,3982,3934,3751,100,9,65,0,9,48,4728,1577,3151,3121,2986,73,9,50,0,3,30,2327,2173,154,459603866.299341,114034.311958
20,48,039,661100,3175,1169,3175,1316,1859,1838,1695,103,16,13,1,10,21,2136,770,1366,1354,1271,59,11,10,1,2,12,1169,1040,129,151663431.69361,64170.864617
21,48,039,661200,4178,1799,4178,1427,2751,2712,2426,149,15,110,2,10,39,3049,935,2114,2088,1886,106,12,77,2,5,26,1799,1619,180,37875205.408994,30861.076755
22,48,039,661300,2676,1069,2676,1379,1297,1279,1194,62,15,7,0,1,18,1920,895,1025,1015,956,44,9,6,0,0,10,1069,924,145,36574878.509534,27716.81983
23,48,039,661400,6760,2680,6760,2080,4680,4616,4442,120,24,19,1,10,64,4936,1304,3632,3598,3483,81,20,13,0,1,34,2680,2473,207,75438463.835928,34260.267314
24,48,039,661501,4726,1713,4726,1666,3060,3026,2848,140,18,19,1,0,34,3483,1076,2407,2391,2264,97,14,15,1,0,16,1713,1607,106,419067631.981551,132654.078911
25,48,039,661502,4623,1664,4623,1157,3466,3411,3172,164,28,39,0,8,55,3399,721,2678,2649,2485,110,23,30,0,1,29,1664,1571,93,682202182.006475,162245.878927
26,48,039,661601,6184,2430,6184,1756,4428,4339,4058,212,26,35,0,8,89,4611,1115,3496,3443,3243,143,24,28,0,5,53,2430,2242,188,254559135.906681,64426.122991
27,48,039,661602,3026,1068,3026,1347,1679,1646,1564,44,0,28,0,10,33,2135,843,1292,1275,1215,34,0,21,0,5,17,1068,996,72,359279536.440387,101944.176662
28,48,039,661700,2767,1209,2767,638,2129,2103,2017,65,12,2,0,7,26,2063,381,1682,1664,1606,40,12,2,0,4,18,1209,1017,192,5473465892.22973,419490.972234
29,48,039,661800,5385,1866,5385,1489,3896,3810,2896,341,17,551,0,5,86,3921,956,2965,2924,2264,256,14,386,0,4,41,1866,1722,144,1740361123.94936,232734.672546
30,48,039,661900,12253,2166,12253,4106,8147,8037,4380,3483,30,126,2,16,110,10440,3166,7274,7203,3816,3258,22,95,2,10,71,2166,1888,278,3313814464.36674,304473.238704
31,48,039,662000,6209,2808,6209,1325,4884,4781,4123,591,36,28,0,3,103,4717,819,3898,3848,3345,448,30,22,0,3,50,2808,2406,402,4371741485.50685,377562.469356
32,48,039,662100,5849,2275,5849,1822,4027,3967,2952,944,17,49,0,5,60,4254,1140,3114,3098,2333,713,13,36,0,3,16,2275,2052,223,1566012185.56094,194556.589116
33,48,039,662200,6736,2463,6736,1490,5246,5148,4209,815,27,86,0,11,98,5090,984,4106,4065,3325,638,19,74,0,9,41,2463,2253,210,1014730109.90743,141710.932269
34,48,039,662300,4499,1846,4499,1131,3368,3321,2915,358,16,27,3,2,47,3196,699,2497,2478,2227,207,14,26,2,2,19,1846,1692,154,37116501.9789,27624.24808
35,48,039,662400,5637,2124,5637,1307,4330,4242,3900,281,16,41,0,4,88,4025,843,3182,3151,2913,187,13,37,0,1,31,2124,1990,134,1017747820.68294,193464.090382
36,48,039,662500,2486,892,2486,702,1784,1755,1494,243,6,12,0,0,29,1873,491,1382,1370,1184,171,4,11,0,0,12,892,821,71,1051593909.24645,164211.806702
37,48,039,662600,3333,1403,3333,521,2812,2773,2446,286,21,19,0,1,39,2446,299,2147,2128,1905,192,16,14,0,1,19,1403,1255,148,345934429.985067,113467.539054
38,48,039,662700,2550,1026,2550,416,2134,2093,1851,217,16,9,0,0,41,1905,270,1635,1619,1430,168,13,8,0,0,16,1026,903,123,2309169104.45501,313869.603376
39,48,039,662800,6470,2735,6470,894,5576,5512,4406,1025,40,25,0,16,64,4779,574,4205,4170,3403,714,23,22,0,8,35,2735,2431,304,1455545850.46857,207539.89287
40,48,039,662900,4833,1983,4833,961,3872,3807,3374,379,19,30,0,5,65,3536,608,2928,2900,2574,287,17,17,0,5,28,1983,1783,200,617920348.059183,147863.839428
41,48,039,663000,4487,1400,4487,915,3572,3532,2675,837,8,9,3,0,40,3537,688,2849,2832,2112,702,6,9,3,0,17,1400,1262,138,667163479.028987,140402.089755
42,48,039,663100,6386,2048,6386,1264,5122,5072,4211,680,13,165,0,3,50,5104,884,4220,4191,3407,649,11,124,0,0,29,2048,1907,141,1094230883.15149,163074.595534
43,48,039,663200,4984,2141,4984,995,3989,3934,3585,206,21,101,0,21,55,3745,632,3113,3083,2825,150,16,77,0,15,30,2141,1980,161,47107290.160886,32637.945269
44,48,039,663300,2661,972,2661,858,1803,1768,1561,164,16,23,2,2,35,1838,538,1300,1289,1154,105,12,16,2,0,11,972,904,68,26768013.367986,25218.421301
45,48,039,663400,6989,3178,6989,1260,5729,5642,4709,476,20,428,3,6,87,5145,809,4336,4296,3645,328,11,306,3,3,40,3178,2848,330,124349084.806044,52133.126153
46,48,039,663500,5561,2407,5561,1554,4007,3942,3579,271,30,60,2,0,65,4104,963,3141,3103,2830,200,26,45,2,0,38,2407,2203,204,39191978.675858,28852.836668
47,48,039,663600,5080,1872,5080,714,4366,4294,4016,159,13,99,1,6,72,3735,444,3291,3258,3066,95,12,79,1,5,33,1872,1820,52,62972287.316921,41323.653735
48,48,039,663700,3471,1480,3471,1197,2274,2215,1871,276,14,45,0,9,59,2512,750,1762,1732,1472,206,12,35,0,7,30,1480,1324,156,40249830.675479,44707.381249
49,48,039,663800,5658,2226,5658,2666,2992,2937,2315,557,13,44,1,7,55,3890,1626,2264,2240,1852,341,11,35,0,1,24,2226,1987,239,61519320.216433,35551.023344
50,48,039,663900,2324,863,2324,1440,884,863,690,161,2,9,0,1,21,1634,921,713,705,584,112,2,6,0,1,8,863,801,62,35335530.95404,33405.458756
51,48,039,664000,4184,1843,4184,2187,1997,1951,1503,422,7,17,0,2,46,2935,1351,1584,1563,1241,298,7,15,0,2,21,1843,1470,373,374230412.105224,95459.770536
52,48,039,664100,5348,2401,5348,2184,3164,3107,2797,261,18,29,0,2,57,3915,1366,2549,2520,2302,179,14,23,0,2,29,2401,1920,481,2201086172.20301,332040.168436
53,48,039,664200,1916,2123,1916,333,1583,1547,1463,52,20,10,0,2,36,1541,224,1317,1298,1240,33,14,9,0,2,19,2123,850,1273,2443228748.14067,416992.332367
54,48,039,664300,5445,2056,5445,3462,1983,1915,1143,725,14,30,0,3,68,3606,2147,1459,1428,892,498,14,21,0,3,31,2056,1745,311,95450191.662686,44521.96701
55,48,039,664400,6591,2595,6591,3765,2826,2706,2030,625,17,28,1,5,120,4322,2264,2058,2008,1545,427,12,22,0,2,50,2595,2076,519,942214525.913945,169677.692271
56,48,039,664501,4925,2423,4925,998,3927,3846,3350,454,20,16,0,6,81,3765,592,3173,3128,2740,357,16,13,0,2,45,2423,1900,523,3915835429.8377,372871.233446
57,48,039,990000,0,0,0,0,0,0,0,0,0,0,0,0,0,0,0,0,0,0,0,0,0,0,0,0,0,0,0,3353232835.44457,371488.903688
58,48,071,710100,6502,2434,6502,656,5846,5769,5496,208,34,26,5,0,77,4612,387,4225,4189,3996,147,24,20,2,0,36,2434,2240,194,1386222628.2973,182300.232768
59,48,071,710200,15543,5478,15543,3076,12467,12308,11025,1039,46,176,6,16,159,10788,1815,8973,8900,8022,714,38,117,2,7,73,5478,5043,435,2362639681.43607,348828.661867
60,48,071,710300,2890,1302,2890,241,2649,2609,1777,797,20,13,2,0,40,2246,154,2092,2067,1411,632,12,11,1,0,25,1302,1123,179,2568462494.26637,237579.801185
61,48,071,710401,6274,2411,6274,1478,4796,4744,4189,499,24,27,0,5,52,4566,852,3714,3680,3251,383,20,21,0,5,34,2411,2208,203,4123399590.56081,380065.294594
62,48,071,710500,3887,1666,3887,1184,2703,2652,2280,274,10,84,0,4,51,2873,759,2114,2095,1799,216,10,66,0,4,19,1666,1338,328,7289315794.60714,449927.501702
63,48,071,710600,0,0,0,0,0,0,0,0,0,0,0,0,0,0,0,0,0,0,0,0,0,0,0,0,0,0,0,6455759140.80554,432132.827363
64,48,071,990000,0,0,0,0,0,0,0,0,0,0,0,0,0,0,0,0,0,0,0,0,0,0,0,0,0,0,0,95819194.023278,49630.635865
65,48,157,670101,6801,1922,6801,3944,2857,2827,193,2579,8,32,0,15,30,4465,2523,1942,1931,172,1723,5,26,0,5,11,1922,1772,150,35999287.185494,30413.724198
66,48,157,670102,3383,1108,3383,1170,2213,2199,47,2115,2,28,0,7,14,2335,748,1587,1577,39,1506,2,25,0,5,10,1108,1045,63,13112657.403575,15736.037421
67,48,157,670200,8322,2566,8322,3234,5088,5041,253,4701,15,63,1,8,47,5839,2053,3786,3762,226,3458,11,61,1,5,24,2566,2440,126,39091788.489028,27865.345221
68,48,157,670300,3801,1260,3801,850,2951,2897,79,2792,0,18,0,8,54,2733,504,2229,2204,67,2118,0,17,0,2,25,1260,1190,70,32237301.647857,29546.363072
69,48,157,670400,5058,1817,5058,742,4316,4267,80,4142,7,25,1,12,49,3569,464,3105,3083,67,2982,4,24,1,5,22,1817,1714,103,28444866.821627,22883.19099
70,48,157,670500,4102,1439,4102,771,3331,3270,275,2885,4,99,4,3,61,3012,509,2503,2469,246,2125,4,90,3,1,34,1439,1367,72,59168829.24794,33998.167514
71,48,157,670601,8975,3027,8975,966,8009,7910,169,7645,9,62,1,24,99,6507,614,5893,5836,144,5609,8,62,1,12,57,3027,2915,112,49006557.788977,28043.865122
72,48,157,670602,1907,652,1907,508,1399,1393,36,1323,8,16,0,10,6,1349,328,1021,1017,31,963,4,14,0,5,4,652,605,47,28683389.80563,21857.930762
73,48,157,670700,3382,1202,3382,750,2632,2578,482,1827,5,261,0,3,54,2426,473,1953,1920,399,1303,3,213,0,2,33,1202,1105,97,318077668.984878,99347.737316
74,48,157,670800,14354,4392,14354,4745,9609,9418,665,8605,14,103,2,29,191,9247,2908,6339,6261,528,5618,11,85,2,17,78,4392,4138,254,158215596.821904,65736.574002
75,48,157,670901,10214,3514,10214,965,9249,8953,2931,3783,25,2180,4,30,296,7411,630,6781,6641,2348,2664,22,1583,3,21,140,3514,3294,220,147208504.263768,54998.332584
76,48,157,670902,5020,1585,5020,1795,3225,3138,285,2768,3,68,0,14,87,3232,1143,2089,2050,232,1750,2,60,0,6,39,1585,1483,102,111159670.014829,51739.779046
77,48,157,671001,5412,2337,5412,584,4828,4755,3420,1137,8,168,6,16,73,4513,426,4087,4042,2990,879,7,151,6,9,45,2337,2237,100,53669279.644814,31334.862946
78,48,157,671002,6459,2368,6459,1268,5191,5053,2035,2835,12,156,0,15,138,4795,817,3978,3903,1740,2008,12,136,0,7,75,2368,2217,151,41509080.969326,33310.634427
79,48,157,671100,8174,2723,8174,3386,4788,4712,1208,2823,17,635,0,29,76,5927,2189,3738,3693,1067,2053,14,542,0,17,45,2723,2595,128,76679111.462198,39351.148412
80,48,157,671200,6153,1983,6153,1871,4282,4226,532,3158,12,500,4,20,56,4400,1253,3147,3107,474,2184,7,424,2,16,40,1983,1894,89,35708473.360689,23873.64522
81,48,157,671300,3834,1317,3834,1282,2552,2489,745,1300,7,425,0,12,63,2627,814,1813,1771,609,813,4,336,0,9,42,1317,1282,35,27492595.659488,26245.709665
82,48,157,671400,8877,3306,8877,2021,6856,6641,1184,2177,31,3213,15,21,215,6342,1286,5056,4918,972,1461,16,2448,7,14,138,3306,3087,219,36115957.68176,24692.407627
83,48,157,671501,7785,2561,7785,853,6932,6756,2237,1575,16,2910,4,14,176,5800,580,5220,5125,1733,1184,14,2185,3,6,95,2561,2506,55,46388753.157341,27728.66883
84,48,157,671502,1682,532,1682,168,1514,1454,335,420,12,679,0,8,60,1256,112,1144,1099,255,309,9,520,0,6,45,532,527,5,19416739.728188,20780.205274
85,48,157,671601,6631,2803,6631,850,5781,5593,3018,442,15,2098,2,18,188,5174,626,4548,4433,2427,328,8,1653,2,15,115,2803,2666,137,33231063.346251,28764.952936
86,48,157,671602,3596,1203,3596,289,3307,3224,1651,295,4,1273,0,1,83,2724,210,2514,2461,1213,232,2,1013,0,1,53,1203,1190,13,25632616.307956,21573.033022
87,48,157,671700,5103,2122,5103,413,4690,4598,3520,260,7,795,1,15,92,4322,321,4001,3945,3040,201,6,685,1,12,56,2122,2056,66,68297831.851728,42662.575761
88,48,157,671800,3011,1230,3011,884,2127,2090,809,813,5,455,1,7,37,2212,593,1619,1592,698,541,5,340,1,7,27,1230,1155,75,138406825.86178,53724.76214
89,48,157,671900,4130,1524,4130,815,3315,3241,2264,370,8,578,5,16,74,3141,526,2615,2581,1847,256,7,460,4,7,34,1524,1484,40,23203888.377669,23925.758287
90,48,157,672001,8542,2767,8542,1484,7058,6868,1743,1141,16,3935,4,29,190,6220,957,5263,5147,1435,818,11,2869,3,11,116,2767,2694,73,102828205.863835,47155.768098
91,48,157,672002,6279,3022,6279,1105,5174,5037,1690,1511,15,1802,0,19,137,5006,769,4237,4141,1481,1144,9,1490,0,17,96,3022,2872,150,28943037.112104,21912.945237
92,48,157,672100,4386,1946,4386,268,4118,4041,2464,190,6,1359,0,22,77,3717,212,3505,3452,2165,154,5,1111,0,17,53,1946,1786,160,81837834.853664,43232.692538
93,48,157,672200,3031,1163,3031,581,2450,2396,1816,331,8,232,1,8,54,2393,429,1964,1936,1484,257,6,184,1,4,28,1163,1113,50,72345211.163374,41760.534788
94,48,157,672301,7796,2471,7796,1599,6197,6018,1324,1100,17,3536,5,36,179,5425,1042,4383,4280,1029,742,15,2473,1,20,103,2471,2391,80,42297839.947268,32522.227902
95,48,157,672302,9225,3224,9225,1416,7809,7646,4552,554,22,2497,6,15,163,6781,927,5854,5786,3609,364,17,1782,4,10,68,3224,3141,83,42720275.677433,33136.851832
96,48,157,672400,8751,2622,8751,3385,5366,5202,1772,1639,23,1755,0,13,164,6164,2195,3969,3871,1441,1043,17,1363,0,7,98,2622,2514,108,45174257.934862,30487.01422
97,48,157,672500,7458,2315,7458,2695,4763,4633,1286,1891,16,1418,0,22,130,5348,1768,3580,3502,1069,1286,11,1125,0,11,78,2315,2231,84,28014892.904663,24047.351836
98,48,157,672601,10258,3030,10258,5248,5010,4867,1383,2463,17,982,1,21,143,6974,3404,3570,3489,1107,1623,12,738,1,8,81,3030,2901,129,39818303.430744,25617.261089
99,48,157,672602,6332,1766,6332,1830,4502,4425,541,2650,5,1213,1,15,77,4241,1185,3056,3022,417,1684,4,905,1,11,34,1766,1708,58,22546453.334399,25001.405968
100,48,157,672701,14078,3865,14078,3386,10692,10414,1411,4108,23,4818,2,52,278,9325,2145,7180,7041,1063,2489,16,3439,2,32,139,3865,3744,121,119843267.17489,43944.315144
101,48,157,672702,6942,2247,6942,1501,5441,5265,2544,1332,10,1360,0,19,176,4835,979,3856,3756,1876,880,10,977,0,13,100,2247,2147,100,37028686.787728,29567.815732
102,48,157,672800,8069,2370,8069,1200,6869,6625,2062,1596,17,2934,8,8,244,6001,889,5112,4965,1638,1183,10,2122,7,5,147,2370,2148,222,122085592.106209,47337.608202
103,48,157,672900,28537,9435,28537,7227,21310,20742,6993,7972,48,5666,2,61,568,19536,4674,14862,14583,5273,5124,33,4110,2,41,279,9435,9032,403,520843440.137719,118951.684876
104,48,157,673001,8459,2957,8459,1022,7437,7287,6111,240,19,894,1,22,150,5880,609,5271,5202,4398,175,16,599,0,14,69,2957,2898,59,57489358.30214,35310.860626
105,48,157,673002,7617,2599,7617,1235,6382,6229,4353,515,12,1310,3,36,153,5135,777,4358,4275,3079,323,6,837,3,27,83,2599,2516,83,155401779.127477,59196.092705
106,48,157,673003,12920,3839,12920,1664,11256,11041,7792,382,43,2788,1,35,215,7999,980,7019,6941,4962,231,23,1705,1,19,78,3839,3785,54,91419492.693491,40848.911697
107,48,157,673101,33201,10736,33201,6380,26821,26213,19432,2265,91,4337,13,75,608,21356,3825,17531,17269,12951,1421,58,2795,13,31,262,10736,10124,612,552476262.46896,122030.955073
108,48,157,673102,15344,5014,15344,2673,12671,12402,8961,596,26,2760,14,45,269,9824,1544,8280,8184,6040,395,18,1708,6,17,96,5014,4861,153,117062855.46156,48090.69831
109,48,157,673200,5677,2038,5677,783,4894,4820,4148,446,22,176,8,20,74,3984,486,3498,3469,2981,340,13,119,6,10,29,2038,1886,152,1327892794.12315,230733.334017
110,48,157,673300,4699,1875,4699,467,4232,4186,3696,351,42,89,0,8,46,3696,321,3375,3344,2989,250,23,74,0,8,31,1875,1749,126,1362113415.46419,257801.589867
111,48,157,673400,14932,5231,14932,2961,11971,11780,9015,1868,50,816,1,30,191,10611,1929,8682,8595,6725,1247,38,571,1,13,87,5231,4970,261,961371027.283414,169495.080075
112,48,157,673500,8541,3133,8541,1063,7478,7356,6093,869,17,363,0,14,122,6186,672,5514,5453,4576,593,14,261,0,9,61,3133,3034,99,111577014.697405,45721.306887
113,48,157,673600,6966,2570,6966,1013,5953,5878,5496,266,6,99,0,11,75,5198,664,4534,4492,4217,186,6,76,0,7,42,2570,2508,62,92898238.538573,39365.400296
114,48,157,673700,2209,18,2209,514,1695,1689,810,870,0,9,0,0,6,2187,509,1678,1672,810,853,0,9,0,0,6,18,17,1,96625189.161974,54418.055388
115,48,157,673800,9342,2934,9342,1669,7673,7370,3043,631,16,3644,9,27,303,6412,1082,5330,5164,2158,423,2,2556,5,20,166,2934,2836,98,162418604.359678,71125.693797
116,48,157,673901,8763,2650,8763,628,8135,7928,4374,426,16,3085,0,27,207,6079,372,5707,5594,3084,299,8,2195,0,8,113,2650,2608,42,59127957.462388,39298.193312
117,48,157,673902,5679,1753,5679,369,5310,5139,1099,225,11,3784,0,20,171,3894,219,3675,3594,797,139,6,2638,0,14,81,1753,1669,84,96910985.628205,46857.504915
118,48,157,674000,7972,3258,7972,716,7256,7098,3422,314,24,3318,5,15,158,6088,501,5587,5485,2799,250,8,2418,3,7,102,3258,3075,183,52534609.761122,28047.940031
119,48,157,674100,6922,2558,6922,876,6046,5886,3847,411,9,1602,6,11,160,5284,583,4701,4620,3041,307,5,1256,4,7,81,2558,2494,64,44678917.474603,27771.273793
120,48,157,674200,5600,1854,5600,321,5279,5176,3010,189,4,1963,0,10,103,4180,228,3952,3897,2265,136,4,1490,0,2,55,1854,1807,47,64455307.163673,45756.098537
121,48,157,674300,8794,2778,8794,756,8038,7824,3192,832,27,3747,0,26,214,6087,481,5606,5505,2285,610,17,2586,0,7,101,2778,2711,67,83733543.426186,41272.970764
122,48,157,674400,10074,3042,10074,656,9418,9177,3729,337,9,5074,1,27,241,6895,420,6475,6334,2645,225,5,3445,1,13,141,3042,2906,136,335717213.306411,143854.493996
123,48,157,674501,6603,2351,6603,774,5829,5671,2282,1890,16,1475,0,8,158,4577,489,4088,3994,1691,1309,15,975,0,4,94,2351,2233,118,253849299.849205,87234.137925
124,48,157,674502,16767,5159,16767,3102,13665,13379,8332,3429,43,1546,8,21,286,10390,1764,8626,8497,5286,2168,26,1004,2,11,129,5159,4907,252,750853229.958779,140554.783562
125,48,157,674601,3762,1429,3762,304,3458,3386,2739,252,11,383,0,1,72,2708,186,2522,2489,2006,181,8,293,0,1,33,1429,1408,21,35768223.361481,27994.764087
126,48,157,674602,7641,2543,7641,980,6661,6538,5021,717,10,777,0,13,123,5029,602,4427,4368,3315,489,6,546,0,12,59,2543,2475,68,312879224.005538,137290.635967
127,48,157,674603,5999,2060,5999,1707,4292,4178,3045,877,13,236,0,7,114,4200,1088,3112,3057,2265,584,10,192,0,6,55,2060,1977,83,27584557.668347,21272.263679
128,48,157,674604,4607,1415,4607,901,3706,3602,1118,1529,5,938,1,11,104,3078,532,2546,2497,858,923,4,706,1,5,49,1415,1375,40,83066596.845174,43052.04846
129,48,157,674700,11165,3551,11165,2213,8952,8757,3555,2978,25,2184,3,12,195,8322,1488,6834,6728,2958,2113,18,1630,3,6,106,3551,3395,156,236950334.038464,88494.186532
130,48,157,674800,5645,2313,5645,3004,2641,2598,1561,967,15,49,1,5,43,4038,1982,2056,2039,1347,635,10,42,1,4,17,2313,2091,222,41987049.944062,26139.35626
131,48,157,674900,5543,1598,5543,4049,1494,1466,465,971,12,14,0,4,28,3859,2667,1192,1171,431,720,8,10,0,2,21,1598,1480,118,108795297.410054,50956.459622
132,48,157,675000,3224,1155,3224,2548,676,662,194,448,5,5,7,3,14,2205,1724,481,476,163,301,2,4,4,2,5,1155,985,170,44679623.73476,34402.799743
133,48,157,675100,9099,3349,9099,4750,4349,4275,2731,1410,13,102,2,17,74,6326,3022,3304,3273,2267,914,9,74,1,8,31,3349,3073,276,83909422.71586,45413.637432
134,48,157,675200,5623,2090,5623,3684,1939,1898,1559,304,8,17,4,6,41,3958,2381,1577,1551,1329,192,6,16,2,6,26,2090,1927,163,65247483.728742,40558.568871
135,48,157,675300,6679,2293,6679,4674,2005,1958,1516,412,6,14,0,10,47,4703,3083,1620,1599,1278,297,5,11,0,8,21,2293,2096,197,101761348.923565,59323.014551
136,48,157,675400,6298,2104,6298,3429,2869,2820,2425,332,5,46,2,10,49,4408,2189,2219,2204,1926,229,5,37,1,6,15,2104,1971,133,1542050039.69494,248413.155573
137,48,157,675500,11151,3874,11151,3986,7165,6988,4027,2215,16,684,1,45,177,7775,2510,5265,5180,3157,1474,13,505,1,30,85,3874,3579,295,3231077669.13827,352011.816586
138,48,157,675600,5808,2152,5808,1697,4111,4067,3920,89,6,43,0,9,44,4210,1048,3162,3145,3034,68,6,37,0,0,17,2152,1964,188,2930820985.57808,328199.690775
139,48,157,675700,6808,2588,6808,2082,4726,4661,4134,481,7,34,2,3,65,4944,1322,3622,3589,3183,369,6,28,2,1,33,2588,2386,202,2534933710.18515,284830.386113
140,48,157,675800,3392,1433,3392,1268,2124,2098,1399,685,2,10,0,2,26,2511,812,1699,1683,1122,549,2,8,0,2,16,1433,1222,211,3510811220.06045,424165.197789
141,48,167,720100,5874,2170,5874,725,5149,5090,4737,82,11,248,1,11,59,4181,458,3723,3683,3452,53,8,164,1,5,40,2170,2100,70,69486601.971408,56775.981979
142,48,167,720200,4465,1860,4465,375,4090,4054,3765,68,12,200,6,3,36,3300,232,3068,3048,2849,45,8,137,6,3,20,1860,1738,122,78805539.916968,65975.668446
143,48,167,720301,2268,935,2268,256,2012,1986,1866,37,5,75,0,3,26,1735,168,1567,1551,1470,26,4,50,0,1,16,935,899,36,35177306.890946,26358.139067
144,48,167,720302,7004,2320,7004,740,6264,6145,5777,140,23,188,3,14,119,5095,458,4637,4579,4299,99,23,143,3,12,58,2320,2269,51,120279875.809978,56797.577779
145,48,167,720400,5923,1870,5923,446,5477,5406,4909,101,22,353,5,16,71,4132,282,3850,3816,3456,89,12,245,3,11,34,1870,1844,26,162136585.769386,56279.852288
146,48,167,720501,4268,1491,4268,645,3623,3544,3127,203,7,195,3,9,79,3058,395,2663,2627,2324,141,7,148,3,4,36,1491,1439,52,48252508.995073,41210.738099
147,48,167,720502,9546,3296,9546,1995,7551,7341,6067,700,27,531,3,13,210,6701,1247,5454,5361,4440,495,20,396,2,8,93,3296,3174,122,78591796.36208,36188.990987
148,48,167,720503,14007,4563,14007,2139,11868,11579,9648,861,39,1000,8,23,289,9322,1298,8024,7897,6571,585,26,698,5,12,127,4563,4441,122,139090380.526612,53575.049637
149,48,167,720600,11205,4169,11205,2502,8703,8484,6335,1448,46,621,17,17,219,7885,1522,6363,6257,4806,948,34,450,12,7,106,4169,3957,212,592603923.959675,136851.48333
150,48,167,720700,9369,3682,9369,1821,7548,7399,5794,784,43,756,8,14,149,6735,1169,5566,5488,4376,526,32,539,4,11,78,3682,3402,280,142186078.739516,54899.439927
151,48,167,720800,3648,1418,3648,863,2785,2731,1664,991,7,62,0,7,54,2782,521,2261,2238,1390,793,6,45,0,4,23,1418,1302,116,55664557.478928,31262.622751
152,48,167,720900,5513,2212,5513,1752,3761,3702,2805,808,19,50,0,20,59,3993,1116,2877,2845,2280,497,14,41,0,13,32,2212,1987,225,72079791.039742,34535.632474
153,48,167,721000,1858,820,1858,364,1494,1459,1378,43,5,28,1,4,35,1471,236,1235,1209,1153,32,5,16,1,2,26,820,733,87,104679092.921793,67101.89995
154,48,167,721100,10440,3740,10440,4686,5754,5633,4397,1058,38,104,0,36,121,7182,2794,4388,4323,3486,702,27,83,0,25,65,3740,3474,266,217092280.955501,67934.364406
155,48,167,721201,17172,6735,17172,2815,14357,14095,12160,1127,41,735,2,30,262,12269,1738,10531,10407,8977,826,37,543,2,22,124,6735,6358,377,168632296.193311,63436.765914
156,48,167,721202,3126,1076,3126,584,2542,2477,2094,260,7,109,0,7,65,2130,354,1776,1740,1470,183,6,79,0,2,36,1076,1023,53,147465582.566539,65844.146981
157,48,167,721300,4699,1996,4699,1216,3483,3429,3173,153,11,82,2,8,54,3560,851,2709,2677,2486,114,9,62,2,4,32,1996,1826,170,72417663.07465,51075.620461
158,48,167,721400,7164,3005,7164,699,6465,6350,5824,265,19,221,4,17,115,5337,471,4866,4815,4391,208,14,187,3,12,51,3005,2727,278,78633912.66229,42699.379302
159,48,167,721500,6767,3591,6767,625,6142,6063,5581,219,17,237,2,7,79,5650,459,5191,5133,4761,172,16,178,2,4,58,3591,3215,376,93695580.845457,51252.391279
160,48,167,721600,1900,864,1900,583,1317,1309,1195,21,10,76,0,7,8,1436,377,1059,1056,972,12,8,58,0,6,3,864,698,166,36642210.934507,43865.601476
161,48,167,721700,7937,3137,7937,2885,5052,4960,4432,272,48,188,6,14,92,5730,1778,3952,3897,3516,190,41,139,5,6,55,3137,2776,361,128821359.546654,50559.522503
162,48,167,721800,4540,2343,4540,1102,3438,3386,3065,30,25,265,0,1,52,3630,690,2940,2898,2663,21,25,189,0,0,42,2343,1870,473,163127191.422781,77393.857962
163,48,167,721900,8613,3740,8613,2061,6552,6439,3267,2983,28,145,6,10,113,6315,1354,4961,4904,2719,2039,24,114,5,3,57,3740,3299,441,813925422.006293,179295.017702
164,48,167,722001,5486,2040,5486,1525,3961,3902,3255,560,16,58,7,6,59,4060,1008,3052,3021,2544,406,12,47,6,6,31,2040,1947,93,90788001.974182,72126.820519
165,48,167,722002,3377,1383,3377,988,2389,2355,1881,435,9,25,0,5,34,2586,658,1928,1913,1553,328,9,18,0,5,15,1383,1282,101,18737196.219407,17864.701926
166,48,167,722100,6627,2510,6627,1839,4788,4695,3992,620,27,52,0,4,93,4893,1167,3726,3685,3210,405,24,42,0,4,41,2510,2339,171,41308136.873695,30726.314906
167,48,167,722200,3116,1483,3116,903,2213,2168,906,1228,11,17,1,5,45,2230,577,1653,1628,705,895,10,16,1,1,25,1483,1177,306,21865408.642701,19990.394054
168,48,167,722300,7335,2810,7335,3228,4107,4028,2707,1266,25,19,3,8,79,5046,2035,3011,2984,2120,825,19,15,3,2,27,2810,2460,350,45109647.366685,32431.852283
169,48,167,722600,2097,1018,2097,400,1697,1668,569,1027,9,55,3,5,29,1614,255,1359,1344,495,789,6,47,2,5,15,1018,910,108,51254927.181473,31092.092056
170,48,167,722700,4200,1771,4200,288,3912,3865,327,3510,19,9,0,0,47,3189,182,3007,2986,288,2673,16,9,0,0,21,1771,1513,258,50128175.741868,31035.900387
171,48,167,722800,2538,1118,2538,739,1799,1768,935,807,12,10,1,3,31,1878,471,1407,1394,816,558,10,6,1,3,13,1118,961,157,27880251.92728,24629.769976
172,48,167,722900,2608,1103,2608,658,1950,1910,1270,619,12,8,0,1,40,1926,419,1507,1492,1072,403,9,7,0,1,15,1103,995,108,22407787.086834,21682.324144
173,48,167,723000,3319,1451,3319,513,2806,2781,650,2104,6,10,3,8,25,2490,336,2154,2142,573,1552,4,9,1,3,12,1451,1281,170,35436244.783839,29031.027927
174,48,167,723100,3216,1563,3216,588,2628,2584,1218,1283,13,59,1,10,44,2560,434,2126,2100,1060,969,9,55,1,6,26,1563,1315,248,47638517.21191,32269.992553
175,48,167,723200,3362,1443,3362,819,2543,2479,1765,685,7,20,1,1,64,2541,509,2032,2002,1458,517,7,18,1,1,30,1443,1260,183,223699662.926208,68524.34208
176,48,167,723300,5457,2141,5457,722,4735,4695,4462,161,15,56,1,0,40,4105,489,3616,3596,3422,115,11,47,1,0,20,2141,2014,127,365600815.950917,86766.542031
177,48,167,723400,6706,2683,6706,854,5852,5784,5676,10,38,51,1,8,68,5058,556,4502,4463,4380,4,29,41,1,8,39,2683,2473,210,498412047.554721,113269.788825
178,48,167,723501,1021,414,1021,138,883,872,865,5,1,0,0,1,11,764,96,668,663,657,4,1,0,0,1,5,414,377,37,58387428.520519,33547.307092
179,48,167,723502,8883,3421,8883,1299,7584,7496,7402,30,35,11,3,15,88,6659,854,5805,5750,5688,15,27,7,2,11,55,3421,3164,257,688434565.34127,121899.984465
180,48,167,723600,4306,1816,4306,784,3522,3484,2827,633,9,15,0,0,38,3252,513,2739,2720,2216,483,9,12,0,0,19,1816,1577,239,1751082425.25354,190692.587942
181,48,167,723700,2170,1013,2170,436,1734,1723,464,1249,8,2,0,0,11,1505,278,1227,1220,377,834,7,2,0,0,7,1013,834,179,65635302.643355,56591.458587
182,48,167,723800,4098,2766,4098,430,3668,3616,3261,281,17,49,3,5,52,3595,331,3264,3231,2967,205,12,39,3,5,33,2766,1944,822,203307523.088627,166271.602064
183,48,167,723900,2417,2707,2417,353,2064,2033,1962,16,35,18,0,2,31,2046,215,1831,1810,1755,14,25,15,0,1,21,2707,1101,1606,6979945183.27375,701772.540997
184,48,167,724000,2393,350,2393,443,1950,1916,1384,492,14,24,1,1,34,2280,382,1898,1868,1359,474,13,20,1,1,30,350,267,83,635007746.556237,108720.824037
185,48,167,724101,1241,1394,1241,252,989,968,637,284,10,35,0,2,21,1045,185,860,849,590,223,6,28,0,2,11,1394,607,787,181622873.213866,109932.76506
186,48,167,724200,2748,1933,2748,528,2220,2156,1185,481,18,470,1,1,64,2253,381,1872,1827,1046,357,16,406,1,1,45,1933,1404,529,12426739.93358,20846.189938
187,48,167,724300,3104,2034,3104,844,2260,2212,1646,390,13,151,3,9,48,2608,623,1985,1956,1487,304,12,141,3,9,29,2034,1351,683,17201774.39184,17683.458622
188,48,167,724400,3312,2189,3312,1041,2271,2223,1314,838,24,37,3,7,48,2754,780,1974,1940,1183,693,18,36,3,7,34,2189,1472,717,12755509.438866,19728.785613
189,48,167,724500,849,755,849,139,710,693,518,139,7,26,0,3,17,771,107,664,653,508,110,7,25,0,3,11,755,515,240,11561590.329237,13597.986456
190,48,167,724600,1793,793,1793,612,1181,1157,98,1049,0,7,2,1,24,1093,391,702,696,80,608,0,5,2,1,6,793,579,214,7527468.650666,15639.120095
191,48,167,724700,1916,1236,1916,609,1307,1290,287,991,8,3,0,1,17,1470,407,1063,1049,250,790,6,3,0,0,14,1236,764,472,8186226.243892,13851.884668
192,48,167,724800,1622,1022,1622,565,1057,1039,601,421,3,9,3,2,18,1308,407,901,891,547,327,3,9,3,2,10,1022,717,305,6981662.576018,12334.184884
193,48,167,724900,1910,975,1910,700,1210,1179,782,375,6,13,2,1,31,1539,524,1015,996,684,292,5,13,1,1,19,975,790,185,6264944.32919,10481.145607
194,48,167,725000,2262,1096,2262,1083,1179,1153,860,266,8,17,1,1,26,1823,799,1024,1010,774,213,8,13,1,1,14,1096,906,190,7774438.364054,13280.41164
195,48,167,725100,1886,971,1886,702,1184,1159,314,820,10,10,1,4,25,1447,493,954,936,270,644,8,9,1,4,18,971,740,231,8628983.388093,16439.822274
196,48,167,725200,1661,938,1661,1004,657,654,178,459,4,12,0,1,3,1230,683,547,544,159,371,4,9,0,1,3,938,595,343,6661828.822972,18912.69581
197,48,167,725300,1898,961,1898,851,1047,1020,796,194,6,23,0,1,27,1443,571,872,859,689,146,6,18,0,0,13,961,727,234,13819672.907257,24969.860883
198,48,167,725400,3906,1833,3906,2140,1766,1723,1242,419,10,49,1,2,43,2972,1529,1443,1412,1058,303,8,40,1,2,31,1833,1516,317,12196315.891672,14743.387491
199,48,167,725500,1118,631,1118,194,924,910,823,71,8,8,0,0,14,931,137,794,785,723,49,6,7,0,0,9,631,512,119,9354943.80167,17237.526856
200,48,167,725600,3097,2862,3097,771,2326,2281,1558,490,19,213,0,1,45,2553,543,2010,1981,1391,408,12,169,0,1,29,2862,1654,1208,22692785.064783,24737.516118
201,48,167,725700,2214,1062,2214,473,1741,1714,1485,132,5,90,2,0,27,1775,332,1443,1426,1258,86,4,77,1,0,17,1062,893,169,14201823.790081,14446.254335
202,48,167,725800,3081,1971,3081,1196,1885,1841,1341,371,10,114,3,2,44,2292,803,1489,1463,1115,247,8,89,3,1,26,1971,1143,828,69823812.51016,52686.299399
203,48,167,725900,2214,2098,2214,465,1749,1697,1428,154,8,103,0,4,52,1927,352,1575,1538,1318,129,8,81,0,2,37,2098,1172,926,113319211.752132,51075.848913
204,48,167,726000,1566,1191,1566,188,1378,1360,1276,34,3,47,0,0,18,1259,141,1118,1107,1044,24,2,37,0,0,11,1191,643,548,805590445.171398,207718.764217
205,48,167,726100,2935,5247,2935,197,2738,2698,2617,39,13,29,0,0,40,2606,156,2450,2416,2346,32,11,27,0,0,34,5247,1468,3779,1361228492.95023,203405.043454
206,48,167,726200,2938,1263,2938,890,2048,1992,828,1137,11,12,0,4,56,2137,572,1565,1540,717,803,9,9,0,2,25,1263,1059,204,442585971.930357,187026.380803
207,48,167,990000,0,0,0,0,0,0,0,0,0,0,0,0,0,0,0,0,0,0,0,0,0,0,0,0,0,0,0,5659878025.04191,649929.728578
208,48,201,100000,4690,2322,4690,1070,3620,3581,2082,1047,22,134,1,295,39,4560,1032,3528,3497,2041,1014,22,126,1,293,31,2322,1737,585,41849144.973316,30733.081912
209,48,201,210100,9652,87,9652,1788,7864,7845,2893,4881,3,58,0,10,19,9469,1747,7722,7704,2839,4795,3,57,0,10,18,87,72,15,7482126.177959,14983.404864
210,48,201,210400,5328,1801,5328,4025,1303,1278,332,904,9,23,1,9,25,3643,2767,876,866,294,539,9,18,1,5,10,1801,1593,208,19524868.859886,20724.774341
211,48,201,210500,4882,1693,4882,4096,786,777,225,535,6,6,0,5,9,3474,2863,611,605,195,395,6,6,0,3,6,1693,1504,189,23158619.881769,20996.585764
212,48,201,210600,5497,2259,5497,4378,1119,1089,935,96,14,36,1,7,30,4209,3204,1005,980,851,75,13,33,1,7,25,2259,2037,222,25115941.384801,20320.651166
213,48,201,210700,2485,865,2485,1891,594,583,85,489,3,3,2,1,11,1761,1288,473,467,70,388,3,3,2,1,6,865,754,111,12179566.861253,15142.741473
214,48,201,210800,2753,1106,2753,1728,1025,1013,51,953,3,1,0,5,12,1947,1113,834,824,37,784,1,1,0,1,10,1106,891,215,39371982.016263,33508.829761
215,48,201,210900,1620,731,1620,362,1258,1253,35,1195,3,20,0,0,5,1247,221,1026,1023,31,971,3,18,0,0,3,731,598,133,13596246.861575,15054.179422
216,48,201,211000,2039,893,2039,570,1469,1456,38,1387,2,23,0,6,13,1527,362,1165,1156,35,1103,2,12,0,4,9,893,777,116,12082672.367193,15298.653053
217,48,201,211100,6004,2356,6004,3156,2848,2816,52,2732,17,8,5,2,32,4223,2010,2213,2190,42,2119,16,8,3,2,23,2356,1954,402,25690923.009937,24593.523704
218,48,201,211200,2831,1383,2831,951,1880,1866,29,1821,4,9,1,2,14,2100,621,1479,1465,25,1429,3,5,1,2,14,1383,1087,296,18336826.006207,20412.924113
219,48,201,211300,5046,2385,5046,1401,3645,3611,113,3484,3,0,1,10,34,3577,868,2709,2689,100,2578,3,0,1,7,20,2385,1858,527,29532863.077733,24877.508356
220,48,201,211400,3690,1537,3690,1310,2380,2362,288,1986,12,70,5,1,18,2526,836,1690,1678,271,1336,7,61,2,1,12,1537,1316,221,40276509.881242,30026.775369
221,48,201,211500,6907,2116,6907,6363,544,534,270,241,6,11,2,4,10,4733,4318,415,406,206,184,5,7,2,2,9,2116,1898,218,65118647.080751,35930.361516
222,48,201,211600,2811,1168,2811,2293,518,513,100,392,11,6,0,4,5,1984,1572,412,408,83,308,8,5,0,4,4,1168,858,310,12531914.08536,14501.116209
223,48,201,211700,3886,1653,3886,1205,2681,2652,42,2587,10,5,2,6,29,2852,779,2073,2054,35,2006,5,3,2,3,19,1653,1408,245,47852280.380907,32876.300877
224,48,201,211900,5225,1567,5225,5057,168,166,124,23,6,9,0,4,2,3526,3388,138,136,110,15,5,4,0,2,2,1567,1417,150,13425311.868258,15360.370033
225,48,201,212300,5381,2066,5381,4808,573,560,288,245,9,15,0,3,13,3851,3353,498,490,258,207,9,14,0,2,8,2066,1699,367,35076946.748998,25964.737576
226,48,201,212400,3216,1042,3216,2919,297,292,82,186,12,7,0,5,5,2254,1995,259,255,77,157,11,7,0,3,4,1042,938,104,87617983.061891,56233.501631
227,48,201,212500,3610,1566,3610,1015,2595,2563,40,2504,4,8,1,6,32,2810,655,2155,2131,32,2087,4,3,0,5,24,1566,1394,172,123044360.755078,76367.784012
228,48,201,220100,2097,725,2097,1038,1059,1047,39,996,9,1,0,2,12,1447,647,800,792,22,761,7,1,0,1,8,725,633,92,19189062.968168,18723.091179
229,48,201,220200,3030,1016,3030,2799,231,229,187,36,5,1,0,0,2,2152,1944,208,206,174,28,3,1,0,0,2,1016,906,110,15879332.032584,19925.077406
230,48,201,220300,4509,1421,4509,4077,432,427,348,55,2,15,0,7,5,3132,2753,379,377,313,45,2,12,0,5,2,1421,1298,123,21316693.203342,19633.676215
231,48,201,220400,5021,1489,5021,4507,514,503,298,191,4,9,0,1,11,3325,2931,394,387,266,111,2,7,0,1,7,1489,1353,136,20515245.184804,19151.057892
232,48,201,220500,4288,1943,4288,3149,1139,1116,585,508,3,19,0,1,23,3310,2238,1072,1053,543,487,3,19,0,1,19,1943,1820,123,25849625.634995,26146.320977
233,48,201,220600,3894,1149,3894,2937,957,952,244,694,6,5,1,2,5,2469,1912,557,555,197,346,4,5,1,2,2,1149,1051,98,17874199.581559,18381.011544
234,48,201,220700,6317,2086,6317,4482,1835,1815,201,1571,10,25,0,8,20,4198,2878,1320,1307,171,1113,9,12,0,2,13,2086,1866,220,44795188.041571,29615.472806
235,48,201,220800,3289,1235,3289,1575,1714,1702,69,1612,6,12,0,3,12,2118,923,1195,1189,63,1111,3,9,0,3,6,1235,1084,151,19355333.536572,20412.252502
236,48,201,220900,1852,550,1852,1499,353,346,49,276,3,15,0,3,7,1213,977,236,233,46,169,2,13,0,3,3,550,480,70,17007993.630722,19441.190317
237,48,201,221000,4037,1187,4037,3148,889,873,326,528,1,7,0,11,16,2679,1993,686,675,284,379,1,5,0,6,11,1187,974,213,26813762.351233,24739.045891
238,48,201,221100,3598,1046,3598,3203,395,394,314,42,5,29,0,4,1,2377,2044,333,332,270,31,5,25,0,1,1,1046,940,106,32973431.418891,25129.732193
239,48,201,221200,5994,1699,5994,5184,810,796,690,91,6,5,2,2,14,4047,3347,700,690,608,69,6,5,1,1,10,1699,1579,120,26911341.998476,21611.719521
240,48,201,221300,8593,2443,8593,7718,875,851,700,109,7,24,3,8,24,5731,4980,751,737,621,84,4,23,3,2,14,2443,2254,189,36933909.360454,25041.789205
241,48,201,221400,6137,1988,6137,5470,667,648,468,161,4,9,0,6,19,4054,3490,564,557,424,117,4,9,0,3,7,1988,1734,254,21730201.916564,19338.655623
242,48,201,221500,8259,2574,8259,6340,1919,1891,583,1257,3,33,1,14,28,5503,4089,1414,1394,513,837,3,32,1,8,20,2574,2377,197,24330986.839599,21008.943938
243,48,201,221600,9217,2584,9217,7551,1666,1633,1385,154,2,77,0,15,33,6182,4710,1472,1455,1267,114,2,62,0,10,17,2584,2427,157,62040738.662149,34013.541415
244,48,201,221700,8245,2247,8245,7326,919,903,690,60,8,136,1,8,16,5257,4472,785,777,611,49,8,101,1,7,8,2247,2066,181,57359483.504256,32991.399785
245,48,201,221800,4285,1206,4285,3913,372,371,347,15,1,6,1,1,1,2672,2352,320,319,298,14,1,5,1,0,1,1206,1086,120,33837152.0247,26797.91629
246,48,201,221900,4888,1339,4888,4396,492,488,410,62,7,6,0,3,4,3117,2705,412,409,347,51,4,5,0,2,3,1339,1209,130,28662645.171865,24064.984264
247,48,201,222000,2507,603,2507,2156,351,339,214,117,7,1,0,0,12,1738,1426,312,303,194,103,5,1,0,0,9,603,574,29,12318984.101221,16447.605734
248,48,201,222100,5621,1506,5621,4954,667,650,502,108,10,23,0,7,17,3697,3157,540,533,419,82,9,20,0,3,7,1506,1395,111,24406248.195134,23113.282424
249,48,201,222200,3726,1075,3726,3122,604,578,271,290,3,5,0,9,26,2505,2020,485,472,224,234,3,5,0,6,13,1075,977,98,32139629.124972,24479.527962
250,48,201,222300,4512,1251,4512,3777,735,714,475,182,3,53,0,1,21,2915,2310,605,594,396,150,3,45,0,0,11,1251,1144,107,53764030.338925,37840.922544
251,48,201,222401,3701,1072,3701,3103,598,588,437,34,3,111,0,3,10,2480,1973,507,503,387,27,3,86,0,0,4,1072,967,105,54531820.763604,40944.044265
252,48,201,222402,5906,1632,5906,4828,1078,1043,683,288,8,60,0,4,35,3838,2974,864,853,585,210,6,50,0,2,11,1632,1500,132,44051565.92244,28352.64005
253,48,201,222501,2860,874,2860,2510,350,345,168,156,0,17,3,1,5,1944,1656,288,284,157,112,0,11,3,1,4,874,756,118,9787799.46017,13373.307153
254,48,201,222502,4025,1083,4025,3269,756,733,563,146,1,23,0,0,23,2681,2056,625,609,486,101,1,21,0,0,16,1083,1042,41,36679240.932125,31006.584513
255,48,201,222503,6614,1970,6614,5818,796,779,321,424,4,25,1,4,17,4371,3737,634,621,291,300,3,24,1,2,13,1970,1718,252,18377773.852604,17484.567896
256,48,201,222600,4947,2127,4947,4053,894,881,106,739,5,27,1,3,13,3305,2578,727,719,94,599,2,22,1,1,8,2127,1707,420,28130167.668627,26236.816269
257,48,201,222700,5175,2239,5175,1225,3950,3919,359,3538,1,18,1,2,31,3255,757,2498,2474,330,2127,1,15,1,0,24,2239,2024,215,76027589.574072,58253.438957
258,48,201,222800,3561,970,3561,2930,631,611,483,42,1,66,0,19,20,2248,1726,522,513,418,29,1,56,0,9,9,970,894,76,72467105.562334,35215.024217
259,48,201,222900,7848,2200,7848,6300,1548,1498,709,707,6,73,0,3,50,5353,4094,1259,1220,608,540,5,65,0,2,39,2200,2062,138,62676592.89918,34915.641266
260,48,201,223001,3591,1058,3591,2689,902,885,265,596,4,17,0,3,17,2330,1678,652,640,238,382,4,16,0,0,12,1058,908,150,33792849.165069,26267.180845
261,48,201,223002,3985,1196,3985,3370,615,599,203,358,2,25,0,11,16,2618,2101,517,503,182,295,0,22,0,4,14,1196,1073,123,7968932.479238,11439.22565
262,48,201,223100,2111,626,2111,1569,542,538,375,147,1,12,0,3,4,1386,942,444,440,309,119,1,11,0,0,4,626,572,54,51476962.183445,35270.435897
263,48,201,230100,1705,688,1705,311,1394,1384,19,1363,1,0,0,1,10,1155,182,973,963,18,943,1,0,0,1,10,688,597,91,14563719.726572,15270.026181
264,48,201,230200,5054,2124,5054,638,4416,4374,112,4235,4,10,0,13,42,3774,383,3391,3362,91,3249,3,10,0,9,29,2124,1838,286,83763484.291707,43996.760137
265,48,201,230300,1803,876,1803,418,1385,1369,28,1339,1,0,0,1,16,1326,227,1099,1086,24,1061,0,0,0,1,13,876,678,198,18773139.240475,19986.797345
266,48,201,230400,3719,1524,3719,1772,1947,1929,52,1869,4,2,1,1,18,2659,1099,1560,1546,45,1493,4,2,1,1,14,1524,1251,273,30931232.199294,24451.09845
267,48,201,230500,4174,1245,4174,3312,862,843,145,678,3,10,1,6,19,2871,2166,705,694,125,556,2,10,1,0,11,1245,1131,114,35662692.966438,36840.834594
268,48,201,230600,2572,1022,2572,881,1691,1674,37,1624,5,7,0,1,17,1899,556,1343,1335,33,1289,5,7,0,1,8,1022,860,162,23315500.646274,25757.049625
269,48,201,230700,2651,1145,2651,630,2021,2001,34,1960,2,0,1,4,20,1839,375,1464,1449,32,1413,2,0,1,1,15,1145,913,232,29039437.897571,29374.076897
270,48,201,230800,2805,1012,2805,637,2168,2161,44,2108,1,1,0,7,7,2105,385,1720,1716,38,1670,1,1,0,6,4,1012,910,102,19929526.035895,20866.226448
271,48,201,230900,4231,1717,4231,764,3467,3432,72,3353,6,0,0,1,35,3003,461,2542,2526,66,2454,5,0,0,1,16,1717,1496,221,68439416.007444,33165.472911
272,48,201,231000,4282,1499,4282,1476,2806,2773,130,2621,11,8,0,3,33,3103,913,2190,2168,117,2034,7,7,0,3,22,1499,1335,164,44412854.257281,31264.2511
273,48,201,231100,4729,1445,4729,2759,1970,1953,295,1632,10,6,2,8,17,3209,1735,1474,1467,261,1181,9,6,2,8,7,1445,1290,155,120318973.354999,49840.359369
274,48,201,231200,6698,2228,6698,1788,4910,4881,146,4712,12,8,0,3,29,4300,1056,3244,3234,121,3096,10,5,0,2,10,2228,2036,192,150342756.870037,60808.54348
275,48,201,231300,4254,1628,4254,837,3417,3392,97,3282,5,1,1,6,25,3040,501,2539,2525,91,2425,2,1,1,5,14,1628,1410,218,51787658.807614,33234.524079
276,48,201,231400,2379,958,2379,108,2271,2255,18,2231,2,2,0,2,16,1921,60,1861,1849,15,1829,1,2,0,2,12,958,905,53,36192290.197869,30715.816555
277,48,201,231500,2706,1075,2706,202,2504,2494,20,2466,1,4,0,3,10,2063,124,1939,1931,14,1912,1,2,0,2,8,1075,949,126,12479327.063494,16472.713844
278,48,201,231600,2822,1087,2822,472,2350,2332,43,2276,9,3,0,1,18,2179,289,1890,1880,39,1830,7,3,0,1,10,1087,998,89,17916434.16702,19338.130108
279,48,201,231700,3867,1108,3867,3391,476,469,319,132,3,8,0,7,7,2427,2055,372,368,263,92,2,8,0,3,4,1108,977,131,45730364.807162,32229.859969
280,48,201,231800,2764,889,2764,1578,1186,1178,97,1069,6,6,0,0,8,1963,989,974,967,86,872,4,5,0,0,7,889,835,54,30384018.522716,25156.973466
281,48,201,231900,6292,2218,6292,1705,4587,4555,245,4265,18,21,0,6,32,4667,1018,3649,3625,207,3384,11,19,0,4,24,2218,2083,135,97319955.099693,44030.155713
282,48,201,232000,4050,1300,4050,2211,1839,1825,181,1623,0,16,0,5,14,2834,1304,1530,1522,165,1341,0,13,0,3,8,1300,1199,101,177184783.356618,60514.559611
283,48,201,232100,2869,1097,2869,1702,1167,1149,258,876,7,5,0,3,18,1954,1076,878,869,226,632,7,4,0,0,9,1097,836,261,34818833.081945,28699.189537
284,48,201,232200,9437,3769,9437,3795,5642,5519,3618,1437,28,411,7,18,123,6588,2307,4281,4213,2793,1081,23,300,6,10,68,3769,3387,382,212380261.100741,85476.683309
285,48,201,232301,8913,2809,8913,5395,3518,3472,1252,2148,19,32,3,18,46,5465,3087,2378,2349,983,1314,15,23,3,11,29,2809,2480,329,278646074.600666,94240.10617
286,48,201,232302,9020,2760,9020,4544,4476,4429,773,3554,10,76,0,16,47,5776,2653,3123,3093,627,2392,7,61,0,6,30,2760,2568,192,128805179.079376,51125.032201
287,48,201,232401,7415,2267,7415,3957,3458,3390,1363,1640,11,363,1,12,68,5001,2397,2604,2561,1124,1157,10,263,1,6,43,2267,2116,151,156036315.481134,66383.308781
288,48,201,232402,3714,1283,3714,1851,1863,1830,262,1461,14,87,1,5,33,2560,1192,1368,1346,220,1033,11,79,1,2,22,1283,1147,136,16025204.187626,16217.022556
289,48,201,232403,4165,1456,4165,2421,1744,1703,275,1349,0,69,0,10,41,2823,1536,1287,1265,240,962,0,58,0,5,22,1456,1234,222,23366312.732563,20676.385519
290,48,201,232500,3135,865,3135,2109,1026,1014,407,582,9,11,0,5,12,2300,1464,836,830,373,440,6,8,0,3,6,865,797,68,124157968.410604,57391.890998
291,48,201,232600,3000,913,3000,2308,692,675,432,225,3,3,0,12,17,2137,1553,584,569,380,178,3,3,0,5,15,913,884,29,65877528.446672,36755.418869
292,48,201,232701,7235,2589,7235,4846,2389,2335,304,1971,7,47,0,6,54,4754,3052,1702,1675,251,1369,5,45,0,5,27,2589,2146,443,50243925.85442,32780.701766
293,48,201,232702,5217,2166,5217,3595,1622,1590,570,949,24,38,0,9,32,3639,2406,1233,1211,505,652,16,31,0,7,22,2166,1697,469,48670038.792187,49594.645103
294,48,201,232800,5201,2244,5201,2656,2545,2476,479,1789,10,190,6,2,69,3708,1748,1960,1921,411,1341,2,162,4,1,39,2244,1987,257,22009410.416176,25905.939053
295,48,201,232900,7254,3028,7254,2851,4403,4326,962,3008,18,332,1,5,77,5272,1886,3386,3334,847,2179,13,290,1,4,52,3028,2683,345,35544960.080709,29430.093981
296,48,201,233001,3133,1540,3133,1329,1804,1781,707,1038,6,23,1,6,23,2160,831,1329,1312,614,670,5,17,1,5,17,1540,1087,453,10177045.813942,15486.68124
297,48,201,233002,3932,1248,3932,1497,2435,2393,788,1443,8,149,2,3,42,2887,976,1911,1884,663,1091,6,120,2,2,27,1248,1209,39,18670697.551463,17686.180847
298,48,201,233003,2235,827,2235,939,1296,1275,1022,204,6,42,1,0,21,1665,574,1091,1077,885,150,4,37,1,0,14,827,769,58,10867808.616328,15367.539129
299,48,201,233101,4107,1373,4107,3176,931,916,705,167,2,42,0,0,15,2668,1904,764,754,599,119,2,34,0,0,10,1373,1179,194,18663763.165723,21653.466071
300,48,201,233102,6676,1899,6676,5568,1108,1094,942,108,9,15,0,20,14,4150,3322,828,819,725,62,8,12,0,12,9,1899,1711,188,26331834.727472,22664.399061
301,48,201,233103,5164,1539,5164,4377,787,762,618,117,8,11,0,8,25,3227,2599,628,614,517,77,7,7,0,6,14,1539,1370,169,17560600.31706,17292.019669
302,48,201,233200,6232,1880,6232,4444,1788,1769,1551,183,8,20,2,5,19,4163,2695,1468,1457,1313,116,6,18,2,2,11,1880,1764,116,34218139.072022,27532.48029
303,48,201,233300,4818,1329,4818,4321,497,492,431,35,15,8,0,3,5,3147,2714,433,431,382,31,10,7,0,1,2,1329,1228,101,125627341.97395,70466.677583
304,48,201,233400,2757,1016,2757,2186,571,564,305,244,3,11,0,1,7,1948,1428,520,514,266,234,3,10,0,1,6,1016,929,87,28184150.57813,30877.674034
305,48,201,233500,7796,2341,7796,6670,1126,1105,989,85,11,12,0,8,21,5341,4353,988,976,872,79,8,11,0,6,12,2341,2117,224,30022059.019184,30220.309536
306,48,201,233600,2127,940,2127,526,1601,1592,10,1571,5,5,0,1,9,1564,293,1271,1262,10,1243,3,5,0,1,9,940,776,164,41571136.715887,33430.848651
307,48,201,233701,5245,1651,5245,3939,1306,1291,582,689,5,7,1,7,15,3559,2475,1084,1076,507,553,4,6,1,5,8,1651,1523,128,80783115.766193,55171.275393
308,48,201,233702,3000,881,3000,2705,295,290,264,16,1,3,0,6,5,1958,1707,251,249,229,13,1,3,0,3,2,881,799,82,26845342.702062,27154.338164
309,48,201,233703,2656,753,2656,2228,428,421,394,16,7,0,0,4,7,1724,1356,368,365,348,8,6,0,0,3,3,753,705,48,82134613.23123,38342.738968
310,48,201,240100,3557,1742,3557,2029,1528,1495,298,1156,9,23,2,7,33,2479,1305,1174,1153,268,847,7,23,2,6,21,1742,1428,314,38684353.606064,34156.315326
311,48,201,240400,6394,2135,6394,3223,3171,3107,1181,1680,16,206,13,11,64,4387,2006,2381,2350,1012,1152,11,161,7,7,31,2135,1976,159,226188688.978024,80490.196919
312,48,201,240501,5418,2455,5418,2709,2709,2669,144,2461,10,27,2,25,40,3486,1657,1829,1804,111,1645,8,22,2,16,25,2455,1936,519,35394720.395481,23968.31915
313,48,201,240502,5594,2746,5594,3128,2466,2424,181,2214,4,19,0,6,42,3711,1975,1736,1709,146,1537,3,18,0,5,27,2746,2200,546,6900996.285726,12715.278564
314,48,201,240600,2657,1168,2657,1586,1071,1048,100,924,5,8,4,7,23,1728,994,734,724,69,634,4,8,2,7,10,1168,968,200,26372501.892196,25729.210322
315,48,201,240701,13642,4259,13642,7255,6387,6267,920,4806,22,450,23,46,120,8702,4439,4263,4214,734,3088,13,344,19,16,49,4259,3832,427,79672363.921598,37523.63006
316,48,201,240702,10524,3046,10524,5511,5013,4896,711,3783,12,356,11,23,117,6424,3287,3137,3082,554,2248,6,256,9,9,55,3046,2844,202,110930544.475336,46652.883467
317,48,201,240801,5157,2891,5157,2423,2734,2680,1329,1213,17,77,33,11,54,3788,1594,2194,2160,1181,874,11,63,25,6,34,2891,2120,771,31682185.502497,24625.397212
318,48,201,240802,3912,1407,3912,1534,2378,2332,1113,1138,6,62,8,5,46,2705,945,1760,1733,946,730,4,47,3,3,27,1407,1316,91,132288339.86323,63478.368265
319,48,201,240901,8671,2893,8671,3618,5053,4941,1690,2996,12,194,32,17,112,5821,2230,3591,3539,1394,1959,10,143,27,6,52,2893,2718,175,62765228.816011,35778.397692
320,48,201,240902,11756,4073,11756,4487,7269,7097,2617,3983,23,399,53,22,172,8104,2845,5259,5169,2206,2578,22,318,32,13,90,4073,3779,294,131843501.398374,49334.695801
321,48,201,241000,8317,2919,8317,2594,5723,5572,4042,1234,30,214,37,15,151,5790,1558,4232,4163,3176,783,23,158,18,5,69,2919,2738,181,189329423.89171,85295.270695
322,48,201,241101,4542,1538,4542,1370,3172,3092,2387,594,9,73,14,15,80,3163,851,2312,2278,1822,384,8,56,4,4,34,1538,1449,89,22028372.924036,24191.176804
323,48,201,241102,11643,3820,11643,3873,7770,7560,4538,2697,15,223,53,34,210,7723,2363,5360,5271,3402,1648,10,168,27,16,89,3820,3584,236,70964001.431926,38508.13877
324,48,201,241103,4298,1695,4298,1284,3014,2931,1556,1208,13,111,33,10,83,2877,782,2095,2053,1240,689,10,91,20,3,42,1695,1572,123,30324653.493708,28003.978986
325,48,201,241200,6931,2446,6931,2012,4919,4799,3140,1416,31,169,11,32,120,4776,1263,3513,3458,2449,843,16,124,7,19,55,2446,2265,181,54055778.910301,41728.184405
326,48,201,241300,10947,3924,10947,2587,8360,8211,5103,2329,31,712,10,26,149,7920,1689,6231,6161,4033,1585,23,501,6,13,70,3924,3738,186,185092717.317942,67307.606458
327,48,201,241400,7931,2965,7931,1827,6104,5965,4837,858,28,207,20,15,139,5736,1117,4619,4560,3797,565,18,157,12,11,59,2965,2814,151,119181143.515114,72188.873861
328,48,201,241500,9146,3325,9146,3438,5708,5609,1624,3722,14,188,44,17,99,6359,2293,4066,4008,1441,2359,12,159,25,12,58,3325,2996,329,361412459.60699,143596.589571
329,48,201,250100,7865,2582,7865,3702,4163,4075,1838,2024,24,164,12,13,88,5378,2237,3141,3095,1564,1368,19,131,7,6,46,2582,2391,191,153612094.542901,65773.652441
330,48,201,250200,8428,2716,8428,3837,4591,4496,1176,3103,12,147,45,13,95,5546,2333,3213,3163,941,2060,10,117,30,5,50,2716,2499,217,65819813.839922,35775.630651
331,48,201,250301,8587,2102,8587,2742,5845,5712,2140,3248,21,260,14,29,133,6482,1911,4571,4483,1747,2493,16,192,7,28,88,2102,1953,149,127730748.92488,48292.020554
332,48,201,250302,9742,3251,9742,2813,6929,6786,3841,2647,26,259,8,5,143,6681,1779,4902,4842,2851,1757,24,198,8,4,60,3251,3112,139,53937614.700114,34687.988162
333,48,201,250401,12134,3799,12134,2889,9245,9013,6583,1936,27,385,47,35,232,7914,1734,6180,6077,4451,1283,21,267,32,23,103,3799,3706,93,50446566.631539,32275.232342
334,48,201,250402,13962,5096,13962,2617,11345,11096,8562,2006,45,428,38,17,249,9746,1613,8133,8020,6298,1337,35,314,29,7,113,5096,4860,236,240315443.02473,94149.43812
335,48,201,250500,5510,1962,5510,1213,4297,4226,2741,1260,9,169,32,15,71,3790,766,3024,2989,2008,818,9,129,19,6,35,1962,1869,93,49105014.142924,37638.820812
336,48,201,250600,7606,3355,7606,3002,4604,4502,2577,1645,24,138,110,8,102,5455,2007,3448,3400,2193,1004,21,115,61,6,48,3355,2844,511,153205047.144544,54592.759606
337,48,201,250701,5373,1870,5373,1344,4029,3959,3078,749,16,112,2,2,70,3842,840,3002,2971,2373,501,12,82,2,1,31,1870,1770,100,212394414.374768,76228.387568
338,48,201,250702,4563,1621,4563,720,3843,3761,3157,455,17,129,2,1,82,3267,448,2819,2776,2362,297,12,102,2,1,43,1621,1564,57,32311529.473102,25598.421894
339,48,201,250800,8129,3053,8129,868,7261,7138,6470,386,11,249,12,10,123,5991,550,5441,5383,4907,270,11,184,8,3,58,3053,2919,134,116373042.323672,46088.392934
340,48,201,250900,8569,3559,8569,596,7973,7892,7459,181,24,205,2,21,81,6238,366,5872,5837,5514,135,16,154,2,16,35,3559,3159,400,180967643.822295,68580.595088
341,48,201,251000,2774,1478,2774,327,2447,2396,2096,150,7,130,3,10,51,2253,239,2014,1980,1767,106,5,92,3,7,34,1478,1341,137,101506083.731257,43221.656851
342,48,201,251100,7400,2967,7400,1095,6305,6217,5672,311,39,166,22,7,88,5712,678,5034,4985,4589,215,35,132,11,3,49,2967,2814,153,120676570.148176,46672.801674
343,48,201,251200,5584,2235,5584,821,4763,4694,4321,223,6,128,9,7,69,4159,538,3621,3587,3314,163,6,91,6,7,34,2235,2046,189,37570672.147624,28129.906089
344,48,201,251300,7159,2665,7159,773,6386,6282,6025,139,16,88,0,14,104,5329,473,4856,4807,4611,103,15,69,0,9,49,2665,2576,89,70359301.012803,32892.009
345,48,201,251401,2446,834,2446,385,2061,2034,1864,80,10,78,0,2,27,1661,229,1432,1421,1304,53,5,59,0,0,11,834,809,25,12965024.675675,17763.30517
346,48,201,251402,5924,2358,5924,943,4981,4915,4619,167,13,103,2,11,66,4295,604,3691,3655,3418,128,11,88,2,8,36,2358,2261,97,28743564.738304,26321.39728
347,48,201,251501,4807,1507,4807,560,4247,4159,3652,128,19,351,4,5,88,3030,321,2709,2674,2336,85,13,233,4,3,35,1507,1440,67,200009168.08651,87178.715651
348,48,201,251502,9419,3633,9419,846,8573,8449,7910,221,21,252,15,30,124,7065,570,6495,6428,6018,164,18,201,8,19,67,3633,3441,192,58637268.959421,30914.856777
349,48,201,251503,2264,798,2264,269,1995,1958,1827,39,6,78,3,5,37,1549,161,1388,1375,1271,30,3,67,2,2,13,798,773,25,9994102.471938,15069.737427
350,48,201,251600,5750,2089,5750,595,5155,5096,4872,144,37,34,1,8,59,4225,372,3853,3816,3643,107,29,30,1,6,37,2089,1937,152,648228054.909395,132055.355535
351,48,201,251700,8069,3048,8069,1139,6930,6854,6494,222,33,83,5,17,76,5742,699,5043,5005,4756,143,25,64,4,13,38,3048,2774,274,863133015.414787,157829.033052
352,48,201,251800,1847,719,1847,332,1515,1500,1450,40,2,5,0,3,15,1392,201,1191,1182,1144,29,2,5,0,2,9,719,663,56,391977017.844333,96140.780193
353,48,201,251901,9353,3441,9353,1392,7961,7817,7237,478,45,39,1,17,144,6655,812,5843,5763,5370,317,33,33,1,9,80,3441,3196,245,549377918.098173,100195.894361
354,48,201,251902,4778,1819,4778,670,4108,4046,3445,561,9,29,1,1,62,3529,428,3101,3063,2638,391,7,25,1,1,38,1819,1727,92,188222079.771058,68055.504531
355,48,201,252000,11296,3951,11296,2534,8762,8557,5810,2160,15,540,6,26,205,7780,1544,6236,6127,4204,1479,11,412,5,16,109,3951,3732,219,618314770.289082,131389.478197
356,48,201,252100,1720,638,1720,553,1167,1147,1001,120,4,18,0,4,20,1285,352,933,921,823,80,4,11,0,3,12,638,596,42,269445530.437778,76060.771754
357,48,201,252200,7944,2748,7944,4582,3362,3272,1715,1274,28,231,2,22,90,5343,2806,2537,2486,1383,902,11,172,1,17,51,2748,2505,243,233694716.821354,64604.291495
358,48,201,252301,8862,2545,8862,5060,3802,3743,855,2624,13,234,0,17,59,5515,2982,2533,2509,657,1651,10,184,0,7,24,2545,2405,140,29376081.519476,29579.125654
359,48,201,252302,11443,3437,11443,6796,4647,4545,1488,2718,19,300,6,14,102,7471,4096,3375,3320,1196,1861,15,237,4,7,55,3437,3232,205,82706101.837919,41909.061284
360,48,201,252400,6976,2262,6976,4095,2881,2831,2549,205,37,29,0,11,50,4771,2497,2274,2257,2070,131,26,25,0,5,17,2262,2105,157,57308991.020439,32760.778592
361,48,201,252500,4325,1547,4325,2845,1480,1448,1369,57,10,7,0,5,32,2908,1716,1192,1176,1111,45,10,7,0,3,16,1547,1335,212,435081698.653835,112131.4771
362,48,201,252600,7552,2545,7552,4726,2826,2777,2638,73,18,35,9,4,49,5093,2773,2320,2286,2182,52,15,29,8,0,34,2545,2304,241,414562112.268344,134963.960747
363,48,201,252700,4163,1660,4163,1153,3010,2960,2684,244,6,18,4,4,50,3031,680,2351,2328,2126,171,6,18,4,3,23,1660,1484,176,510014621.968,121306.641421
364,48,201,252800,5882,2226,5882,1424,4458,4398,1748,2623,9,12,0,6,60,4210,856,3354,3325,1390,1918,5,6,0,6,29,2226,1979,247,691862739.072658,134312.111547
365,48,201,252900,7768,3067,7768,1921,5847,5765,5479,211,40,26,0,9,82,5777,1145,4632,4589,4384,148,29,23,0,5,43,3067,2834,233,198241733.128339,71997.746793
366,48,201,253000,3888,1518,3888,1014,2874,2833,1330,1474,15,11,0,3,41,2787,603,2184,2159,1018,1117,14,7,0,3,25,1518,1352,166,185593556.384416,62067.59848
367,48,201,253100,8439,2588,8439,3376,5063,4937,2962,1592,13,348,2,20,126,5457,1972,3485,3420,2081,1065,12,251,2,9,65,2588,2490,98,314678687.994446,80215.224556
368,48,201,253200,9429,3685,9429,2677,6752,6664,5141,1355,51,99,3,15,88,6838,1687,5151,5112,4121,864,37,80,3,7,39,3685,3399,286,396689725.356932,129405.241086
369,48,201,253300,3428,1372,3428,798,2630,2614,2397,184,10,16,2,5,16,2643,494,2149,2142,1985,135,8,12,2,0,7,1372,1263,109,231613962.83509,65860.735326
370,48,201,253400,724,293,724,360,364,361,321,38,2,0,0,0,3,562,236,326,323,290,31,2,0,0,0,3,293,243,50,142034962.642981,53775.209817
371,48,201,253500,8382,3188,8382,3313,5069,4955,2762,1943,9,217,7,17,114,5701,2004,3697,3646,2178,1275,8,165,7,13,51,3188,2842,346,63181703.278134,45160.065373
372,48,201,253600,5002,3075,5002,1552,3450,3357,2044,1183,7,110,5,8,93,3835,1002,2833,2785,1805,879,7,84,3,7,48,3075,2156,919,60039991.270317,37172.961368
373,48,201,253700,5227,2300,5227,1883,3344,3301,2271,904,11,110,3,2,43,3924,1205,2719,2691,1951,634,11,90,3,2,28,2300,2052,248,43578006.164474,30238.467936
374,48,201,253800,7717,2760,7717,3558,4159,4100,2942,1038,26,72,0,22,59,5242,2074,3168,3137,2350,715,13,45,0,14,31,2760,2494,266,81242630.960818,44096.341172
375,48,201,253900,4416,1925,4416,1280,3136,3077,2459,543,7,64,0,4,59,3209,764,2445,2407,1979,365,6,55,0,2,38,1925,1728,197,49031528.443225,41669.333002
376,48,201,254000,3594,1592,3594,1330,2264,2232,1623,535,10,50,3,11,32,2539,784,1755,1736,1335,351,7,36,3,4,19,1592,1325,267,29322654.369242,24082.790209
377,48,201,254100,5141,1913,5141,2771,2370,2312,1687,572,10,16,2,25,58,3564,1750,1814,1783,1353,392,8,13,2,15,31,1913,1690,223,34742813.755629,28254.265883
378,48,201,254200,3052,1035,3052,2217,835,814,623,179,4,4,0,4,21,1988,1326,662,653,508,137,2,4,0,2,9,1035,902,133,13551437.411719,15100.057877
379,48,201,254300,4917,1993,4917,2822,2095,2049,1268,661,12,105,1,2,46,3405,1757,1648,1620,1061,454,12,92,1,0,28,1993,1607,386,33620144.246822,23169.94777
380,48,201,254400,3253,1167,3253,2436,817,802,352,441,0,3,1,5,15,2173,1531,642,633,293,333,0,3,1,3,9,1167,928,239,30847872.458638,33621.248722
381,48,201,254500,2356,897,2356,1564,792,775,207,552,11,4,0,1,17,1606,1055,551,540,167,366,3,4,0,0,11,897,747,150,74453889.759925,59650.881301
382,48,201,254600,4067,1398,4067,2912,1155,1130,628,475,16,10,1,0,25,2820,1944,876,859,508,327,13,10,1,0,17,1398,1224,174,86196696.983594,50984.070784
383,48,201,254700,2029,896,2029,593,1436,1419,1084,257,6,71,0,1,17,1512,367,1145,1132,895,183,5,48,0,1,13,896,774,122,322748313.254509,101468.110279
384,48,201,310100,5884,2515,5884,2617,3267,3195,1276,1785,13,119,0,2,72,4509,1921,2588,2532,1200,1205,13,112,0,2,56,2515,2204,311,36510642.522745,31309.899813
385,48,201,310200,1463,883,1463,331,1132,1099,535,427,0,133,0,4,33,1299,280,1019,994,522,350,0,119,0,3,25,883,738,145,20108797.960954,19604.271956
386,48,201,310300,4774,2300,4774,3566,1208,1155,785,207,20,132,2,9,53,3727,2656,1071,1030,719,171,14,117,2,7,41,2300,1804,496,24203728.972526,20086.987233
387,48,201,310400,4084,1547,4084,3789,295,285,191,67,6,15,0,6,10,2996,2741,255,248,159,66,6,14,0,3,7,1547,1319,228,18731427.862476,19177.754008
388,48,201,310500,4856,1677,4856,4396,460,450,244,183,6,12,2,3,10,3449,3040,409,403,220,165,5,11,1,1,6,1677,1439,238,33994345.267249,24354.527183
389,48,201,310600,6025,2228,6025,5375,650,629,427,131,8,60,0,3,21,4367,3794,573,557,399,103,2,51,0,2,16,2228,1928,300,19110383.098945,18645.936277
390,48,201,310700,4167,1498,4167,3454,713,695,579,64,6,45,0,1,18,3001,2361,640,627,525,56,4,41,0,1,13,1498,1309,189,21250390.529941,20387.354758
391,48,201,310800,2490,1024,2490,2309,181,177,132,40,0,3,0,2,4,1647,1497,150,148,117,26,0,3,0,2,2,1024,746,278,20784295.830927,21885.118592
392,48,201,310900,5770,2115,5770,5492,278,269,161,78,6,14,2,8,9,4026,3773,253,247,150,72,6,13,2,4,6,2115,1793,322,18857959.272267,21117.255025
393,48,201,311000,7111,2474,7111,6913,198,193,133,36,8,9,0,7,5,4994,4818,176,172,125,29,5,9,0,4,4,2474,2126,348,26367623.694509,24006.623936
394,48,201,311100,5886,2078,5886,5692,194,183,128,30,7,13,0,5,11,4134,3983,151,145,106,25,4,9,0,1,6,2078,1795,283,29445667.207161,26732.974944
395,48,201,311200,4908,1769,4908,4530,378,368,303,50,2,6,1,6,10,3488,3163,325,321,260,47,2,6,1,5,4,1769,1520,249,33038889.294992,26006.660822
396,48,201,311300,5242,1587,5242,4929,313,300,237,37,10,13,0,3,13,3615,3330,285,274,221,32,8,13,0,0,11,1587,1447,140,15761441.100257,19293.400306
397,48,201,311400,1496,572,1496,1275,221,220,48,167,2,3,0,0,1,1026,841,185,184,40,139,2,3,0,0,1,572,470,102,28250035.48426,22937.258715
398,48,201,311500,7611,2357,7611,6966,645,633,295,88,2,236,1,11,12,5327,4785,542,531,257,73,2,190,1,8,11,2357,2139,218,25026761.310856,26899.843488
399,48,201,311600,4103,1499,4103,3797,306,291,83,190,1,12,0,5,15,2691,2430,261,251,75,162,1,10,0,3,10,1499,1220,279,5285881.5065,9554.243118
400,48,201,311700,5593,1827,5593,4679,914,889,261,552,2,66,0,8,25,3794,3061,733,717,235,419,2,58,0,3,16,1827,1668,159,29566888.0531,28670.999231
401,48,201,311800,4542,1353,4542,4270,272,268,201,39,8,11,0,9,4,3069,2838,231,228,180,29,3,9,0,7,3,1353,1230,123,26815576.510441,26644.626048
402,48,201,311900,2448,770,2448,2198,250,239,153,52,1,31,0,2,11,1707,1495,212,202,133,41,1,27,0,0,10,770,697,73,22795989.062903,24646.451789
403,48,201,312000,4089,1451,4089,399,3690,3599,1317,1665,12,590,6,9,91,3891,379,3512,3434,1277,1546,12,584,6,9,78,1451,1267,184,20151800.274089,32008.077615
404,48,201,312100,2725,12,2725,389,2336,2326,924,830,13,476,0,83,10,2706,386,2320,2310,918,820,13,476,0,83,10,12,11,1,14332331.241491,15077.444333
405,48,201,312200,2058,1192,2058,403,1655,1644,45,1589,0,9,0,1,11,1537,237,1300,1293,40,1243,0,9,0,1,7,1192,812,380,11697938.181426,13953.401872
406,48,201,312300,1962,1142,1962,384,1578,1568,134,1382,0,49,1,2,10,1553,255,1298,1291,128,1114,0,46,1,2,7,1142,845,297,15191937.541541,15510.181853
407,48,201,312400,2208,1351,2208,282,1926,1913,82,1803,0,27,0,1,13,1698,180,1518,1508,80,1402,0,25,0,1,10,1351,954,397,11652757.680147,18465.120928
408,48,201,312500,4235,1818,4235,754,3481,3410,1694,1393,10,302,0,11,71,3864,627,3237,3185,1624,1261,10,282,0,8,52,1818,1622,196,19271830.542771,19686.90417
409,48,201,312600,5871,4287,5871,996,4875,4749,2629,1548,12,544,2,14,126,5163,772,4391,4295,2450,1331,11,496,2,5,96,4287,3031,1256,23300812.064757,22964.838588
410,48,201,312700,1955,1209,1955,136,1819,1787,77,1684,2,19,0,5,32,1596,99,1497,1477,73,1378,2,19,0,5,20,1209,920,289,8677611.870407,12360.381636
411,48,201,312800,2332,728,2332,146,2186,2167,21,2140,3,1,2,0,19,1794,78,1716,1697,18,1673,3,1,2,0,19,728,655,73,10060479.999861,13173.842595
412,48,201,312900,3941,2102,3941,169,3772,3726,134,3537,10,35,0,10,46,3349,119,3230,3192,124,3015,9,34,0,10,38,2102,1683,419,15503386.062251,16217.17479
413,48,201,313000,2349,1461,2349,161,2188,2135,164,1928,3,31,0,9,53,1910,121,1789,1763,157,1570,3,30,0,3,26,1461,1118,343,11887720.875142,14288.729629
414,48,201,313100,3356,1896,3356,391,2965,2903,1845,566,4,474,4,10,62,3110,350,2760,2712,1753,518,4,423,4,10,48,1896,1556,340,42820200.98837,31867.595692
415,48,201,313200,3798,2071,3798,387,3411,3361,228,3059,13,56,1,4,50,3029,254,2775,2734,207,2469,8,48,1,1,41,2071,1632,439,33295430.944738,31808.64474
416,48,201,313300,2654,1161,2654,361,2293,2278,75,2196,3,2,0,2,15,2028,226,1802,1791,62,1723,3,2,0,1,11,1161,1021,140,24621718.586006,21879.70327
417,48,201,313400,2935,1439,2935,700,2235,2213,54,2135,8,13,0,3,22,2203,420,1783,1766,45,1701,7,12,0,1,17,1439,1134,305,19995505.769845,22818.311473
418,48,201,313500,2501,1026,2501,490,2011,1993,26,1959,1,5,0,2,18,1802,298,1504,1489,23,1459,1,5,0,1,15,1026,856,170,17514932.204172,17641.391045
419,48,201,313600,4831,1867,4831,1236,3595,3556,74,3448,9,22,0,3,39,3378,787,2591,2576,68,2484,6,18,0,0,15,1867,1627,240,24924368.847779,23118.682031
420,48,201,313700,2457,1023,2457,192,2265,2244,32,2200,2,8,0,2,21,1913,127,1786,1776,31,1734,2,7,0,2,10,1023,929,94,14241808.201622,17265.412103
421,48,201,313800,4774,2034,4774,467,4307,4270,39,4180,11,22,7,11,37,3102,270,2832,2811,33,2736,8,19,7,8,21,2034,1772,262,23713386.961727,20925.971121
422,48,201,313900,4495,2884,4495,534,3961,3838,1452,1453,7,913,2,11,123,3968,440,3528,3430,1340,1235,7,837,2,9,98,2884,2468,416,29856488.082589,24727.041395
423,48,201,314001,2759,1828,2759,267,2492,2387,934,517,9,922,0,5,105,2517,246,2271,2182,885,453,8,832,0,4,89,1828,1606,222,15248063.664102,22760.944586
424,48,201,314002,7544,4370,7544,763,6781,6664,1848,1528,3,3252,8,25,117,6885,698,6187,6084,1745,1339,1,2967,8,24,103,4370,3925,445,19889857.592149,19991.055261
425,48,201,314300,3962,2476,3962,392,3570,3528,200,3168,10,146,1,3,42,3115,289,2826,2798,184,2474,10,127,1,2,28,2476,2093,383,16344033.236458,18462.837621
426,48,201,314400,3093,2327,3093,333,2760,2667,1139,229,0,1288,2,9,93,2696,292,2404,2335,1063,213,0,1053,2,4,69,2327,1791,536,25768964.006157,23131.201716
427,48,201,320100,2876,1068,2876,2525,351,339,166,116,5,52,0,0,12,1954,1670,284,274,141,91,4,38,0,0,10,1068,908,160,10588636.777324,15709.770787
428,48,201,320200,6662,2246,6662,5095,1567,1539,495,159,16,855,0,14,28,4537,3298,1239,1216,441,121,13,633,0,8,23,2246,1986,260,44906086.470945,33458.733842
429,48,201,320500,4618,1230,4618,4121,497,482,446,20,8,8,0,0,15,3062,2641,421,413,389,12,6,6,0,0,8,1230,1163,67,62545303.242937,38487.863861
430,48,201,320601,2638,863,2638,2347,291,284,239,24,0,18,0,3,7,1771,1519,252,248,210,23,0,14,0,1,4,863,777,86,15220800.005498,18825.555288
431,48,201,320602,4537,1502,4537,4053,484,470,263,170,1,35,0,1,14,3100,2677,423,413,235,147,0,31,0,0,10,1502,1286,216,16349581.848447,22252.765174
432,48,201,320700,3849,1622,3849,2617,1232,1212,534,323,7,346,0,2,20,2722,1719,1003,991,488,225,7,270,0,1,12,1622,1333,289,37150997.560336,35068.614041
433,48,201,320800,5367,1590,5367,4906,461,440,374,21,2,41,0,2,21,3617,3229,388,373,320,17,2,33,0,1,15,1590,1499,91,31459408.439408,24657.779591
434,48,201,320900,7394,2486,7394,5487,1907,1871,954,788,12,104,8,5,36,5040,3546,1494,1479,811,559,9,89,8,3,15,2486,2178,308,24942411.27328,23762.949812
435,48,201,321000,7508,2662,7508,5722,1786,1741,1200,413,4,122,0,2,45,5111,3637,1474,1450,1058,293,4,93,0,2,24,2662,2265,397,42748882.049291,26310.329558
436,48,201,321100,7397,2717,7397,4741,2656,2598,1286,795,16,474,10,17,58,5142,3034,2108,2073,1085,597,10,365,6,10,35,2717,2536,181,59844339.306303,33038.692487
437,48,201,321200,4284,1517,4284,3503,781,764,503,219,6,30,0,6,17,2692,2122,570,563,417,119,3,20,0,4,7,1517,1261,256,32002750.344051,27602.609299
438,48,201,321300,5546,2151,5546,4230,1316,1293,688,544,15,45,0,1,23,3732,2715,1017,1005,612,344,10,38,0,1,12,2151,1778,373,16774335.511587,18902.307523
439,48,201,321401,4383,1280,4383,3797,586,574,515,36,1,12,0,10,12,2955,2456,499,487,446,23,1,12,0,5,12,1280,1199,81,22234121.478552,22722.208389
440,48,201,321402,4248,1419,4248,3582,666,656,578,47,11,20,0,0,10,2889,2323,566,560,511,27,8,14,0,0,6,1419,1199,220,21256957.276169,23175.866926
441,48,201,321500,2985,969,2985,2669,316,307,215,77,8,6,0,1,9,1860,1624,236,233,176,44,7,5,0,1,3,969,895,74,10130610.751104,15720.286021
442,48,201,321600,6785,2049,6785,5255,1530,1509,1385,75,12,33,0,4,21,4632,3306,1326,1310,1216,51,10,30,0,3,16,2049,1945,104,31077605.616439,29899.284219
443,48,201,321700,3049,1011,3049,2275,774,764,708,25,4,19,1,7,10,2150,1449,701,694,649,22,4,13,1,5,7,1011,954,57,20850533.697849,20969.197259
444,48,201,321800,4108,1156,4108,3614,494,489,416,49,4,15,0,5,5,2777,2346,431,430,380,32,2,12,0,4,1,1156,1100,56,14081473.292706,16665.841007
445,48,201,321900,5855,1665,5855,4899,956,934,861,49,6,16,0,2,22,3836,3018,818,806,749,38,4,13,0,2,12,1665,1549,116,26565581.627798,27064.690398
446,48,201,322000,4258,1827,4258,3770,488,474,291,156,4,19,0,4,14,2663,2323,340,331,220,89,4,16,0,2,9,1827,1284,543,7713536.912952,16518.711031
447,48,201,322100,4101,1405,4101,3333,768,739,657,47,7,24,0,4,29,2773,2127,646,626,563,34,7,18,0,4,20,1405,1189,216,23428533.907568,27317.444655
448,48,201,322200,1688,568,1688,1434,254,246,224,15,1,6,0,0,8,1119,910,209,203,188,8,1,6,0,0,6,568,484,84,10312545.379667,14227.589941
449,48,201,322600,5329,1801,5329,3318,2011,1974,1863,68,11,27,0,5,37,3681,2046,1635,1616,1533,51,8,22,0,2,19,1801,1722,79,27218298.327106,25971.621469
450,48,201,322700,7400,2315,7400,5337,2063,2025,1881,110,9,15,4,6,38,4909,3265,1644,1614,1524,63,7,14,3,3,30,2315,2143,172,22263372.247285,22765.949851
451,48,201,322800,6414,1842,6414,5220,1194,1177,1124,27,12,8,0,6,17,4214,3236,978,969,935,13,12,4,0,5,9,1842,1709,133,33552771.171458,26120.857482
452,48,201,322900,4186,1276,4186,3543,643,631,554,47,5,13,4,8,12,2709,2173,536,529,475,33,5,11,2,3,7,1276,1156,120,17882441.086771,21236.004924
453,48,201,323000,6318,2275,6318,5420,898,866,717,113,6,20,2,8,32,3974,3257,717,703,600,73,6,19,2,3,14,2275,2011,264,15057737.096526,17066.252195
454,48,201,323100,3333,1262,3333,2734,599,583,415,144,8,12,1,3,16,2159,1722,437,429,320,90,8,8,1,2,8,1262,1014,248,22144743.108395,26175.260309
455,48,201,323200,5612,1764,5612,4067,1545,1511,1356,109,16,27,0,3,34,3741,2441,1300,1278,1175,67,11,22,0,3,22,1764,1651,113,22668053.32428,20007.021015
456,48,201,323300,3510,1233,3510,2640,870,842,699,100,9,28,4,2,28,2392,1672,720,704,584,82,9,23,4,2,16,1233,1113,120,14101620.370707,17029.945599
457,48,201,323400,7431,2276,7431,5743,1688,1652,1541,72,13,18,3,5,36,4859,3459,1400,1378,1297,50,9,15,3,4,22,2276,2136,140,21412442.706643,22801.408062
458,48,201,323500,5377,2076,5377,4129,1248,1217,968,206,6,33,0,4,31,3409,2473,936,922,766,125,6,22,0,3,14,2076,1705,371,28759679.016868,23834.964757
459,48,201,323600,8378,3437,8378,4067,4311,4242,3724,254,16,238,0,10,69,6229,2630,3599,3561,3181,173,10,190,0,7,38,3437,3236,201,54455542.202612,37951.551763
460,48,201,323701,4158,2044,4158,1385,2773,2722,2395,156,15,147,1,8,51,3440,1002,2438,2401,2140,125,13,116,1,6,37,2044,1857,187,24932856.825641,19784.507583
461,48,201,323702,3219,1306,3219,1370,1849,1810,1643,68,10,82,2,5,39,2396,866,1530,1509,1378,53,7,67,2,2,21,1306,1232,74,11399556.008444,14189.311424
462,48,201,323801,3896,1267,3896,2398,1498,1472,1418,31,6,14,0,3,26,2775,1494,1281,1266,1226,21,3,13,0,3,15,1267,1210,57,14373105.290481,17799.907843
463,48,201,323802,4844,1693,4844,3142,1702,1683,1580,81,5,12,0,5,19,3362,1914,1448,1437,1370,47,5,11,0,4,11,1693,1596,97,25959146.191671,21031.790564
464,48,201,323900,3875,1670,3875,2297,1578,1544,1393,123,15,12,1,0,34,2755,1420,1335,1314,1214,77,11,11,1,0,21,1670,1525,145,30725055.401427,22790.294998
465,48,201,324000,5561,2027,5561,2253,3308,3279,2774,61,12,418,6,8,29,4169,1476,2693,2676,2292,51,10,312,5,6,17,2027,1947,80,86918917.70963,55748.020814
466,48,201,324100,5540,1836,5540,4724,816,802,677,62,8,43,8,4,14,3702,3006,696,686,592,47,7,34,4,2,10,1836,1588,248,247132375.686043,82781.772734
467,48,201,324200,1647,471,1647,1550,97,96,58,24,7,7,0,0,1,1101,1031,70,70,49,11,4,6,0,0,0,471,437,34,78905338.139439,43384.179051
468,48,201,330100,8313,2332,8313,4744,3569,3531,88,3347,1,81,0,14,38,5608,3005,2603,2586,74,2427,1,77,0,7,17,2332,2228,104,27689501.972842,21914.08037
469,48,201,330200,4243,1370,4243,2205,2038,2009,145,1824,6,31,0,3,29,2938,1384,1554,1538,122,1380,6,29,0,1,16,1370,1280,90,47794296.889947,29424.382522
470,48,201,330301,7169,1844,7169,5011,2158,2113,224,1617,10,252,2,8,45,4511,3044,1467,1442,159,1074,2,202,2,3,25,1844,1798,46,34661128.370281,23833.961377
471,48,201,330302,5527,1785,5527,3137,2390,2353,220,2087,9,29,1,7,37,3830,2013,1817,1793,193,1568,5,22,1,4,24,1785,1566,219,66516472.950436,33766.106787
472,48,201,330303,4061,1531,4061,1989,2072,2052,227,1789,5,30,0,1,20,2815,1238,1577,1567,216,1323,3,25,0,0,10,1531,1377,154,56267157.599545,34793.589955
473,48,201,330400,4663,1502,4663,2499,2164,2141,169,1931,4,24,0,13,23,3224,1617,1607,1599,149,1421,4,23,0,2,8,1502,1421,81,47069147.386474,27647.921478
474,48,201,330500,4121,1204,4121,2360,1761,1735,144,1574,6,5,0,6,26,2807,1475,1332,1311,118,1181,5,5,0,2,21,1204,1132,72,29417665.399617,26499.957845
475,48,201,330600,6424,2065,6424,2491,3933,3895,231,3569,10,81,0,4,38,4528,1639,2889,2864,203,2582,7,70,0,2,25,2065,1933,132,39900427.296554,26711.215426
476,48,201,330700,7796,2207,7796,5079,2717,2675,243,2342,9,76,2,3,42,5076,3175,1901,1878,199,1609,4,62,2,2,23,2207,2080,127,67309854.295921,36797.300522
477,48,201,330800,8571,3176,8571,2291,6280,6190,772,5107,12,272,6,21,90,5988,1497,4491,4439,667,3528,7,216,5,16,52,3176,2976,200,341953827.884996,111310.665564
478,48,201,330900,7886,2961,7886,3043,4843,4757,676,3753,7,309,0,12,86,5445,1873,3572,3523,591,2675,6,244,0,7,49,2961,2731,230,107781974.76786,44179.696837
479,48,201,331100,3843,1661,3843,461,3382,3367,53,3302,4,6,1,1,15,2728,289,2439,2431,45,2377,4,3,1,1,8,1661,1400,261,34759603.946167,25983.883724
480,48,201,331200,3473,1663,3473,222,3251,3228,51,3166,3,3,1,4,23,2467,140,2327,2309,42,2257,2,3,1,4,18,1663,1425,238,38160782.936174,26934.755975
481,48,201,331300,4647,1913,4647,318,4329,4311,15,4289,3,4,0,0,18,3583,182,3401,3392,12,3374,3,3,0,0,9,1913,1729,184,49001206.648094,30737.737922
482,48,201,331400,2520,1098,2520,88,2432,2412,11,2371,3,26,0,1,20,1514,45,1469,1460,11,1424,1,23,0,1,9,1098,1011,87,17009984.430878,17516.718165
483,48,201,331500,7145,2820,7145,780,6365,6316,222,5999,20,64,0,11,49,5430,470,4960,4937,196,4663,14,58,0,6,23,2820,2636,184,100330354.103126,45320.019978
484,48,201,331601,6458,2538,6458,478,5980,5951,46,5879,6,18,0,2,29,4757,277,4480,4462,37,4404,4,15,0,2,18,2538,2265,273,33119322.002509,24458.21236
485,48,201,331602,2340,1611,2340,338,2002,1973,66,1898,3,5,0,1,29,1527,190,1337,1318,59,1251,3,4,0,1,19,1611,802,809,64376019.949078,34002.626544
486,48,201,331700,3971,1492,3971,404,3567,3544,34,3497,7,3,0,3,23,2799,235,2564,2551,28,2513,7,3,0,0,13,1492,1368,124,55474281.781405,41444.916661
487,48,201,331800,3682,1429,3682,439,3243,3212,44,3152,10,6,0,0,31,2575,261,2314,2293,36,2249,3,5,0,0,21,1429,1233,196,25084218.989467,22054.770893
488,48,201,331900,3364,1319,3364,273,3091,3077,29,3031,7,6,0,4,14,2527,163,2364,2354,26,2312,6,6,0,4,10,1319,1174,145,18098381.238501,18846.125745
489,48,201,332000,5593,2058,5593,1048,4545,4507,47,4376,2,75,0,7,38,3729,631,3098,3068,43,2974,2,42,0,7,30,2058,1790,268,23791882.576578,20042.564924
490,48,201,332100,3037,991,3037,1471,1566,1558,39,1510,1,4,0,4,8,2094,871,1223,1218,33,1176,1,4,0,4,5,991,881,110,11564801.823524,15933.090956
491,48,201,332200,4985,1623,4985,1987,2998,2977,52,2903,5,11,1,5,21,3535,1209,2326,2315,44,2252,4,9,1,5,11,1623,1470,153,30569506.152082,23429.560059
492,48,201,332300,2918,1062,2918,671,2247,2232,34,2177,9,6,2,4,15,2188,410,1778,1770,23,1731,5,6,1,4,8,1062,964,98,12619757.286177,14599.983095
493,48,201,332400,4271,1524,4271,557,3714,3686,61,3603,6,8,0,8,28,3358,371,2987,2966,54,2900,3,7,0,2,21,1524,1423,101,39515795.413537,31233.713127
494,48,201,332500,3257,1081,3257,1484,1773,1768,181,1566,6,7,0,8,5,2371,931,1440,1438,169,1252,5,5,0,7,2,1081,1016,65,21346064.498953,27306.040153
495,48,201,332600,6605,2098,6605,4130,2475,2459,263,2129,18,39,1,9,16,4606,2635,1971,1959,239,1665,14,34,1,6,12,2098,2008,90,35615675.405496,26734.719569
496,48,201,332700,2728,824,2728,2466,262,258,163,79,2,13,0,1,4,1879,1659,220,216,141,62,2,10,0,1,4,824,763,61,27247856.184679,26339.316725
497,48,201,332800,4617,1496,4617,3955,662,653,194,440,4,13,0,2,9,3064,2560,504,497,174,306,3,13,0,1,7,1496,1274,222,21087767.013442,20782.464738
498,48,201,332900,5049,1502,5049,4474,575,557,344,173,7,30,1,2,18,3411,2898,513,504,309,159,5,28,1,2,9,1502,1319,183,19874148.431819,19278.032722
499,48,201,333000,3315,1063,3315,2857,458,452,322,81,2,47,0,0,6,2324,1915,409,406,294,64,2,46,0,0,3,1063,943,120,16565404.025173,21156.183989
500,48,201,333100,3663,1394,3663,1630,2033,2013,295,693,0,1015,0,10,20,2604,1078,1526,1512,268,509,0,727,0,8,14,1394,1238,156,13307498.1548,17695.657564
501,48,201,333201,4998,1794,4998,3643,1355,1338,296,927,5,94,0,16,17,3493,2441,1052,1041,258,694,4,77,0,8,11,1794,1605,189,12315029.673338,14485.891092
502,48,201,333202,5674,2564,5674,3473,2201,2180,390,1707,8,64,2,9,21,3990,2287,1703,1689,347,1274,8,52,2,6,14,2564,2172,392,24083342.22477,24252.649448
503,48,201,333300,9372,3349,9372,6381,2991,2916,634,2043,4,230,1,4,75,6037,4031,2006,1962,536,1238,3,184,1,0,44,3349,2991,358,74439438.312394,40514.882288
504,48,201,333500,6433,2429,6433,4611,1822,1774,401,1285,7,75,2,4,48,4379,2969,1410,1375,370,926,7,67,2,3,35,2429,2058,371,20367242.583933,18694.349594
505,48,201,333600,3156,1188,3156,1902,1254,1227,876,299,11,35,0,6,27,2339,1291,1048,1035,754,240,6,30,0,5,13,1188,1072,116,39229777.419116,31621.149736
506,48,201,333700,3156,973,3156,2402,754,740,387,222,6,123,0,2,14,2146,1537,609,598,333,165,3,96,0,1,11,973,906,67,96489441.844445,49371.324633
507,48,201,333800,9228,2907,9228,6583,2645,2578,835,1507,2,212,4,18,67,6263,4183,2080,2038,721,1130,2,172,4,9,42,2907,2659,248,94033378.363267,44581.008763
508,48,201,333901,8311,2246,8311,5048,3263,3193,660,1124,11,1386,1,11,70,5315,3054,2261,2236,506,747,6,969,0,8,25,2246,2184,62,52344588.884449,31616.580403
509,48,201,333902,8217,3054,8217,4845,3372,3284,1294,1405,14,551,11,9,88,5752,3129,2623,2564,1099,1014,12,427,9,3,59,3054,2843,211,46064877.482206,32000.124977
510,48,201,334001,3178,1156,3178,1439,1739,1680,547,949,3,173,0,8,59,2154,905,1249,1208,467,595,3,137,0,6,41,1156,1081,75,14457667.473761,16750.951766
511,48,201,334002,2089,1171,2089,730,1359,1327,625,531,2,162,5,2,32,1681,547,1134,1115,568,409,2,132,2,2,19,1171,1038,133,14408969.719104,16222.592412
512,48,201,334003,5976,2360,5976,2823,3153,3088,1795,853,5,414,3,18,65,4414,1864,2550,2518,1552,618,4,329,3,12,32,2360,2155,205,29824316.867881,25189.314865
513,48,201,334100,9914,4315,9914,2599,7315,7223,886,5645,26,653,3,10,92,7355,1709,5646,5571,802,4189,20,550,3,7,75,4315,3897,418,299417616.589466,91276.94349
514,48,201,340100,4618,2106,4618,1704,2914,2835,1536,854,7,429,2,7,79,3331,1130,2201,2157,1244,558,5,343,2,5,44,2106,1918,188,91089033.386095,45560.864637
515,48,201,340201,1653,864,1653,189,1464,1405,901,42,2,459,0,1,59,1187,127,1060,1030,683,33,2,311,0,1,30,864,615,249,195468298.682623,59582.576572
516,48,201,340202,4577,1401,4577,407,4170,4072,2620,139,13,1288,0,12,98,3104,265,2839,2795,1815,89,9,879,0,3,44,1401,1381,20,95081208.746316,48282.25489
517,48,201,340203,4035,1676,4035,264,3771,3710,3035,85,10,572,1,7,61,3047,183,2864,2840,2348,62,8,417,1,4,24,1676,1584,92,123611360.544346,63169.593377
518,48,201,340301,4278,1441,4278,322,3956,3881,2945,92,4,839,0,1,75,3124,202,2922,2885,2190,72,2,620,0,1,37,1441,1416,25,38787767.546193,24999.996965
519,48,201,340302,6814,2487,6814,657,6157,6040,5103,195,25,696,1,20,117,5066,421,4645,4593,3886,138,18,539,1,11,52,2487,2431,56,36874199.763193,27688.871865
520,48,201,340400,1358,537,1358,95,1263,1235,1066,31,3,133,0,2,28,1092,68,1024,1008,877,26,2,103,0,0,16,537,530,7,17268836.644407,16615.294609
521,48,201,340500,6367,3106,6367,1768,4599,4482,3560,466,10,433,9,4,117,4956,1174,3782,3704,2991,339,9,354,7,4,78,3106,2736,370,30382995.650502,22625.718246
522,48,201,340600,2511,988,2511,273,2238,2212,2021,67,7,115,0,2,26,1987,174,1813,1801,1635,59,7,99,0,1,12,988,971,17,17491014.487927,16782.463956
523,48,201,340700,7167,2700,7167,1433,5734,5566,3890,439,34,1173,12,18,168,5250,903,4347,4261,3088,299,19,835,11,9,86,2700,2583,117,34413541.893347,27123.208825
524,48,201,340800,5734,2058,5734,714,5020,4886,3749,245,14,856,5,17,134,4234,473,3761,3697,2819,187,12,672,2,5,64,2058,2012,46,31051667.755307,23831.130143
525,48,201,340900,4216,2164,4216,1220,2996,2888,1829,587,11,443,6,12,108,3222,829,2393,2324,1524,457,7,325,4,7,69,2164,1962,202,42852953.040182,26738.749283
526,48,201,341000,6799,3720,6799,1511,5288,5132,3719,902,16,477,2,16,156,5427,1060,4367,4264,3168,690,13,380,2,11,103,3720,3413,307,32554793.109892,22764.916084
527,48,201,341100,3832,2039,3832,1658,2174,2112,1540,399,19,139,2,13,62,3073,1207,1866,1826,1363,320,16,117,2,8,40,2039,1682,357,49939747.054083,29811.477157
528,48,201,341201,3974,1968,3974,1395,2579,2505,1692,651,9,129,3,21,74,3051,1005,2046,2013,1463,417,9,107,3,14,33,1968,1720,248,90663645.072162,42290.228794
529,48,201,341202,4833,2834,4833,711,4122,4028,3645,193,26,152,6,6,94,4076,516,3560,3515,3198,153,23,133,3,5,45,2834,2412,422,54983310.190913,37712.85871
530,48,201,341301,4864,2971,4864,797,4067,3960,2806,371,26,746,2,9,107,4181,561,3620,3539,2555,313,21,642,2,6,81,2971,2694,277,129868663.59816,52511.73199
531,48,201,341302,3133,1717,3133,754,2379,2299,1455,335,13,488,4,4,80,2499,532,1967,1905,1250,249,8,393,3,2,62,1717,1553,164,21980934.904554,21308.04922
532,48,201,341400,5156,2210,5156,524,4632,4555,4038,172,11,318,1,15,77,3881,301,3580,3533,3186,86,9,242,1,9,47,2210,1908,302,167801649.069109,77503.330334
533,48,201,341501,6449,2917,6449,869,5580,5476,4994,219,20,217,6,20,104,4854,550,4304,4245,3894,153,19,161,4,14,59,2917,2627,290,46145267.484772,34823.329389
534,48,201,341502,3902,2207,3902,411,3491,3422,3060,177,8,174,1,2,69,3050,305,2745,2711,2436,134,8,130,1,2,34,2207,1786,421,51490002.152779,38365.774055
535,48,201,341600,5463,2153,5463,823,4640,4549,4176,151,21,179,10,12,91,4018,493,3525,3485,3211,109,18,137,4,6,40,2153,1983,170,225628883.116321,83833.888585
536,48,201,341700,2455,1276,2455,352,2103,2078,1919,123,24,6,1,5,25,1936,230,1706,1690,1586,73,20,6,1,4,16,1276,1010,266,31449470.495287,39958.457491
537,48,201,341800,1843,822,1843,371,1472,1450,1370,56,6,16,0,2,22,1398,227,1171,1159,1101,40,6,10,0,2,12,822,713,109,48896259.110115,37972.954001
538,48,201,342001,6843,2332,6843,1243,5600,5517,4979,71,20,428,11,8,83,5114,812,4302,4249,3838,50,17,337,2,5,53,2332,2293,39,55611006.975149,32355.26814
539,48,201,342002,3413,1262,3413,966,2447,2414,2022,42,5,333,2,10,33,2536,640,1896,1873,1579,31,5,255,2,1,23,1262,1211,51,39835444.864649,28281.535929
540,48,201,342100,4384,1491,4384,1863,2521,2490,2253,82,16,130,4,5,31,3152,1149,2003,1984,1802,54,12,109,4,3,19,1491,1442,49,48236559.850485,29919.736347
541,48,201,342200,4217,2098,4217,2346,1871,1836,1631,125,22,53,0,5,35,3038,1490,1548,1524,1365,93,18,46,0,2,24,2098,1495,603,30752252.004111,23863.768834
542,48,201,342300,6442,2395,6442,2776,3666,3607,3284,176,35,103,7,2,59,4391,1683,2708,2685,2460,114,25,79,5,2,23,2395,2112,283,30082976.802198,24068.793724
543,48,201,342400,3104,1197,3104,1564,1540,1518,1372,94,9,39,3,1,22,2169,993,1176,1165,1058,64,5,34,3,1,11,1197,1127,70,36517963.728462,31271.34505
544,48,201,342500,6260,2514,6260,1338,4922,4845,4682,66,20,76,0,1,77,4880,894,3986,3944,3813,47,18,65,0,1,42,2514,2393,121,69658392.779528,36498.096102
545,48,201,342700,5054,1945,5054,1074,3980,3930,3832,31,12,48,2,5,50,3755,646,3109,3083,3007,19,10,40,2,5,26,1945,1867,78,37255947.172176,29618.738851
546,48,201,342800,8854,2865,8854,1932,6922,6849,6540,99,18,181,5,6,73,6162,1142,5020,4986,4775,57,14,132,5,3,34,2865,2813,52,80394528.154626,37064.732995
547,48,201,342900,5437,2036,5437,1307,4130,4084,3947,54,22,53,4,4,46,4132,839,3293,3264,3164,37,15,43,4,1,29,2036,1961,75,63980604.956415,33980.696141
548,48,201,343000,7423,2847,7423,2487,4936,4829,4290,343,21,149,19,7,107,5311,1566,3745,3685,3304,233,13,116,14,5,60,2847,2688,159,61873919.061191,36455.688902
549,48,201,343100,4629,1666,4629,1133,3496,3438,3152,212,28,41,4,1,58,3384,714,2670,2643,2434,151,24,30,4,0,27,1666,1612,54,21616287.159703,18776.469066
550,48,201,343200,4944,1631,4944,1377,3567,3506,3225,197,20,60,1,3,61,3523,866,2657,2633,2429,141,14,48,1,0,24,1631,1594,37,49203116.066179,30509.327139
551,48,201,343301,4452,1530,4452,1453,2999,2950,2767,100,20,54,3,6,49,3201,909,2292,2266,2131,74,11,45,1,4,26,1530,1473,57,124309896.307176,55591.451933
552,48,201,343302,4763,1710,4763,1265,3498,3429,3117,247,13,38,2,12,69,3459,823,2636,2604,2375,182,9,32,2,4,32,1710,1639,71,48607178.345515,33456.756252
553,48,201,343600,3317,1426,3317,1113,2204,2128,1825,257,20,21,0,5,76,2464,705,1759,1721,1509,181,13,16,0,2,38,1426,1221,205,764912219.108601,162855.648367
554,48,201,343700,2945,1202,2945,1069,1876,1838,1219,574,4,39,1,1,38,2130,680,1450,1429,964,427,3,34,1,0,21,1202,1053,149,444841741.190417,120278.058538
555,48,201,350100,15280,4845,15280,4568,10712,10491,4561,2496,22,3374,7,31,221,10768,2872,7896,7797,3819,1589,16,2352,4,17,99,4845,4711,134,216241376.149489,113855.981864
556,48,201,350200,8405,2757,8405,4125,4280,4190,2697,847,21,608,1,16,90,6049,2657,3392,3351,2212,618,17,495,1,8,41,2757,2623,134,38135633.194687,27136.06043
557,48,201,350300,5904,2070,5904,2114,3790,3711,2477,785,12,426,1,10,79,4510,1402,3108,3069,2102,597,10,349,1,10,39,2070,2003,67,24536832.56466,20053.135146
558,48,201,350400,6182,2106,6182,2957,3225,3136,1408,1099,10,592,14,13,89,4236,1841,2395,2347,1159,705,5,458,13,7,48,2106,1993,113,28465477.353373,22329.997136
559,48,201,350500,6848,2364,6848,3489,3359,3269,1530,863,18,842,4,12,90,4801,2221,2580,2530,1232,628,11,647,2,10,50,2364,2226,138,62916120.670019,36220.709815
560,48,201,350601,4115,1554,4115,922,3193,3065,2392,365,1,302,1,4,128,3029,606,2423,2365,1831,273,1,257,1,2,58,1554,1488,66,143646683.918454,69251.471549
561,48,201,350602,8714,2996,8714,1686,7028,6869,4730,959,30,1130,8,12,159,6123,1054,5069,4983,3449,673,20,828,8,5,86,2996,2908,88,34465464.196099,28701.922473
562,48,201,350700,2272,861,2272,391,1881,1831,1721,73,6,20,0,11,50,1740,259,1481,1456,1389,45,6,11,0,5,25,861,831,30,15834378.857495,30001.925326
563,48,201,350801,4855,2077,4855,1283,3572,3427,2792,440,18,169,4,4,145,3546,853,2693,2628,2161,322,13,127,3,2,65,2077,1926,151,20367325.468519,24118.884039
564,48,201,350802,7084,3072,7084,1268,5816,5685,4129,648,15,873,7,13,131,5254,829,4425,4363,3211,468,15,655,4,10,62,3072,2833,239,161352709.466126,64831.968126
565,48,201,410100,3793,2126,3793,709,3084,3000,1275,1403,13,300,1,8,84,3033,545,2488,2432,1240,890,13,282,1,6,56,2126,1972,154,13144293.055776,15820.620778
566,48,201,410200,4202,2878,4202,774,3428,3343,2942,136,13,245,2,5,85,3940,667,3273,3208,2833,127,12,229,2,5,65,2878,2559,319,13954697.674234,14823.841964
567,48,201,410300,2621,1708,2621,379,2242,2202,1854,146,4,187,0,11,40,2404,320,2084,2053,1747,124,4,168,0,10,31,1708,1513,195,11104083.477625,14457.404525
568,48,201,410401,3807,2397,3807,672,3135,3075,2781,89,6,182,2,15,60,3420,542,2878,2832,2567,82,6,164,2,11,46,2397,2193,204,9459846.243657,12410.430391
569,48,201,410402,2556,1571,2556,673,1883,1833,1582,86,2,154,0,9,50,2249,512,1737,1711,1476,79,2,148,0,6,26,1571,1418,153,7820721.143161,11656.310756
570,48,201,410500,4209,2920,4209,740,3469,3392,2996,125,8,254,0,9,77,3940,656,3284,3232,2866,119,8,230,0,9,52,2920,2538,382,11842327.253752,17608.882665
571,48,201,410600,3206,2700,3206,435,2771,2707,2305,184,10,192,3,13,64,3091,366,2725,2664,2279,172,10,188,3,12,61,2700,2206,494,10880503.923952,15635.69582
572,48,201,410701,3640,2617,3640,572,3068,3014,2647,220,6,129,3,9,54,3413,506,2907,2862,2510,211,5,124,3,9,45,2617,2296,321,11653829.171359,15461.684063
573,48,201,410702,2622,1782,2622,554,2068,2018,1563,192,4,251,2,6,50,2460,465,1995,1949,1507,191,4,240,2,5,46,1782,1506,276,9789184.392952,17531.348308
574,48,201,410800,3818,2575,3818,984,2834,2755,2456,109,4,178,4,4,79,3362,772,2590,2531,2260,102,4,159,4,2,59,2575,2267,308,11082622.813884,13270.030768
575,48,201,410900,2684,1809,2684,514,2170,2127,1845,127,3,146,1,5,43,2421,421,2000,1969,1717,113,1,132,1,5,31,1809,1615,194,8079529.716981,17618.260323
576,48,201,411000,4162,3345,4162,462,3700,3646,3159,135,8,338,2,4,54,3883,420,3463,3417,2972,120,8,312,2,3,46,3345,2717,628,15641321.877247,20651.591001
577,48,201,411100,3450,1775,3450,343,3107,3074,2754,101,5,206,0,8,33,2732,255,2477,2466,2232,77,5,150,0,2,11,1775,1598,177,14478089.539351,17220.720178
578,48,201,411200,1803,770,1803,99,1704,1689,1597,14,2,74,0,2,15,1413,81,1332,1322,1250,11,2,57,0,2,10,770,715,55,37578660.787316,39974.221163
579,48,201,411300,3383,2689,3383,558,2825,2784,2230,241,8,298,3,4,41,3178,500,2678,2643,2145,207,8,277,3,3,35,2689,2268,421,15430291.356012,18652.879812
580,48,201,411400,2775,1317,2775,108,2667,2657,2551,34,1,70,0,1,10,2183,84,2099,2096,2021,23,1,50,0,1,3,1317,1200,117,18625704.604058,22769.37599
581,48,201,411501,5233,4199,5233,720,4513,4427,3635,271,5,504,5,7,86,4781,629,4152,4080,3347,243,5,475,4,6,72,4199,3272,927,16436976.927934,16020.538854
582,48,201,411502,3916,2891,3916,519,3397,3338,2699,193,7,428,2,9,59,3629,465,3164,3114,2536,169,7,391,2,9,50,2891,2591,300,19732141.091852,22548.100881
583,48,201,411600,2307,1280,2307,181,2126,2091,1949,57,6,78,1,0,35,1929,156,1773,1753,1631,51,6,64,1,0,20,1280,1129,151,14697401.97808,15943.642193
584,48,201,411700,2774,2049,2774,468,2306,2260,1635,245,5,373,1,1,46,2601,415,2186,2144,1565,233,5,339,1,1,42,2049,1893,156,13045338.720983,14613.741835
585,48,201,411800,4835,3196,4835,539,4296,4204,3354,153,11,669,2,15,92,4122,435,3687,3627,2947,130,9,530,0,11,60,3196,2852,344,23143391.315225,29732.131617
586,48,201,411900,3681,2298,3681,362,3319,3256,2936,77,9,224,2,8,63,3181,271,2910,2864,2573,69,9,208,2,3,46,2298,2051,247,19349151.659974,22166.574654
587,48,201,412000,2892,1449,2892,179,2713,2657,2391,44,9,207,0,6,56,2321,130,2191,2157,1947,29,7,171,0,3,34,1449,1306,143,16094153.263554,18670.762094
588,48,201,412100,2328,4,2328,305,2023,1979,1006,110,0,858,4,1,44,2322,305,2017,1974,1005,109,0,855,4,1,43,4,4,0,13095350.006398,15555.024358
589,48,201,412200,5355,2515,5355,449,4906,4785,3920,130,5,715,0,15,121,4206,351,3855,3793,3108,107,5,566,0,7,62,2515,2271,244,25960044.130372,22472.741084
590,48,201,412300,6527,2572,6527,411,6116,5972,5396,29,9,526,0,12,144,4658,272,4386,4341,3928,21,7,379,0,6,45,2572,2414,158,25623031.361867,21330.142999
591,48,201,412400,4541,1622,4541,293,4248,4182,3758,33,15,347,0,29,66,3101,182,2919,2903,2623,19,7,243,0,11,16,1622,1556,66,18169607.077225,26444.452646
592,48,201,412500,1715,663,1715,137,1578,1543,1229,43,3,261,0,7,35,1215,100,1115,1098,863,31,1,198,0,5,17,663,645,18,6910564.791943,15266.441073
593,48,201,412600,3737,1359,3737,323,3414,3337,2923,52,3,353,0,6,77,2515,187,2328,2299,2017,34,2,246,0,0,29,1359,1295,64,13042314.747523,18041.23999
594,48,201,412700,3262,1416,3262,359,2903,2854,2364,53,1,427,0,9,49,2457,251,2206,2180,1824,46,1,303,0,6,26,1416,1329,87,22159273.343606,20026.765003
595,48,201,412800,4930,1738,4930,462,4468,4380,3529,48,16,780,0,7,88,3247,290,2957,2916,2367,31,10,502,0,6,41,1738,1642,96,22081745.686062,19511.252945
596,48,201,412900,3892,2338,3892,494,3398,3297,1968,573,7,735,4,10,101,3291,385,2906,2840,1722,487,7,611,4,9,66,2338,2034,304,22563457.356873,21360.831208
597,48,201,413000,3460,1716,3460,543,2917,2853,2241,165,13,420,5,9,64,2570,375,2195,2172,1704,124,11,321,5,7,23,1716,1454,262,17395834.803946,20203.775945
598,48,201,413100,3087,1182,3087,284,2803,2713,2389,71,4,243,0,6,90,2144,162,1982,1940,1696,57,4,180,0,3,42,1182,1096,86,15570780.670635,19890.506813
599,48,201,413201,2626,1872,2626,360,2266,2211,1508,161,3,533,0,6,55,2378,304,2074,2025,1404,149,3,467,0,2,49,1872,1552,320,5204955.886926,13718.831693
600,48,201,413202,2878,2181,2878,454,2424,2359,1586,188,5,572,1,7,65,2624,405,2219,2165,1514,164,5,474,1,7,54,2181,1829,352,6101318.836662,11797.111377
601,48,201,413300,6897,3595,6897,901,5996,5861,3790,942,14,1099,7,9,135,5542,681,4861,4775,3105,767,14,878,5,6,86,3595,3243,352,34728217.094954,27668.744895
602,48,201,420100,3062,1541,3062,1251,1811,1773,394,1040,5,324,4,6,38,2339,843,1496,1472,345,846,5,270,4,2,24,1541,1388,153,12417180.752756,16907.070058
603,48,201,420200,2547,976,2547,1191,1356,1286,782,219,4,271,1,9,70,1945,810,1135,1090,682,171,3,228,1,5,45,976,918,58,17626487.155354,23292.474043
604,48,201,420300,3411,1687,3411,448,2963,2897,2153,572,5,157,2,8,66,2766,328,2438,2397,1759,496,5,129,2,6,41,1687,1593,94,25814409.331195,21544.92577
605,48,201,420400,3393,1602,3393,617,2776,2721,2285,175,4,255,0,2,55,2743,437,2306,2271,1923,136,4,206,0,2,35,1602,1514,88,26495768.459999,20887.067265
606,48,201,420500,4041,1439,4041,2956,1085,1071,130,648,2,286,0,5,14,2721,1854,867,859,111,500,2,245,0,1,8,1439,1251,188,24799866.202322,22238.93099
607,48,201,420600,2232,1019,2232,655,1577,1536,1212,218,1,103,0,2,41,1721,421,1300,1277,1035,151,1,88,0,2,23,1019,940,79,12969662.910935,19673.162663
608,48,201,420700,3139,1249,3139,275,2864,2824,2467,79,0,264,0,14,40,2405,190,2215,2198,1937,51,0,201,0,9,17,1249,1204,45,24705860.238288,22901.845477
609,48,201,420800,2512,1000,2512,194,2318,2281,1854,35,8,383,0,1,37,1979,141,1838,1825,1496,25,6,297,0,1,13,1000,965,35,22503558.147399,19048.517993
610,48,201,420900,6231,2297,6231,506,5725,5619,4610,116,6,875,1,11,106,4417,338,4079,4042,3334,82,2,620,1,3,37,2297,2167,130,37675457.862172,30988.963677
611,48,201,421000,2497,1002,2497,276,2221,2159,1786,58,0,298,0,17,62,1818,181,1637,1617,1338,45,0,227,0,7,20,1002,938,64,20070342.90529,25061.430807
612,48,201,421101,3729,1735,3729,2276,1453,1419,595,530,3,291,0,0,34,2756,1514,1242,1212,528,433,3,248,0,0,30,1735,1634,101,13442591.645485,18214.872838
613,48,201,421102,5544,2301,5544,4193,1351,1319,222,691,6,384,0,16,32,3840,2704,1136,1113,180,556,4,363,0,10,23,2301,1837,464,9028333.04632,12093.402516
614,48,201,421201,4399,1891,4399,3499,900,882,170,554,1,148,0,9,18,3137,2402,735,721,155,437,0,124,0,5,14,1891,1662,229,4904957.031452,8976.909825
615,48,201,421202,4145,1683,4145,3712,433,415,78,273,1,58,0,5,18,2790,2498,292,279,63,172,1,41,0,2,13,1683,1293,390,6065125.210658,12581.021766
616,48,201,421300,6635,2565,6635,3752,2883,2720,717,730,8,1255,0,10,163,4611,2542,2069,1964,526,565,4,861,0,8,105,2565,2255,310,15975013.085205,17754.47879
617,48,201,421401,3626,1374,3626,3120,506,493,78,190,3,214,0,8,13,2458,2085,373,365,61,119,2,180,0,3,8,1374,1093,281,3073692.571479,8044.182688
618,48,201,421402,3440,1382,3440,3293,147,143,52,80,0,8,0,3,4,2221,2113,108,107,32,68,0,6,0,1,1,1382,1017,365,1735238.49421,5274.29557
619,48,201,421403,4363,1339,4363,3685,678,657,216,243,0,193,0,5,21,3027,2520,507,489,179,152,0,156,0,2,18,1339,1226,113,7038756.818331,10616.743809
620,48,201,421500,6484,2781,6484,3772,2712,2643,836,1232,9,553,0,13,69,4774,2545,2229,2176,723,930,9,503,0,11,53,2781,2426,355,16425658.395385,18544.717448
621,48,201,421600,7014,2355,7014,5704,1310,1284,576,286,5,397,0,20,26,4562,3594,968,953,459,195,3,284,0,12,15,2355,2022,333,15678215.068938,20649.084932
622,48,201,421700,4560,1896,4560,1556,3004,2964,2236,152,4,566,0,6,40,3480,1022,2458,2434,1879,112,4,433,0,6,24,1896,1801,95,20351762.122172,21034.892516
623,48,201,421800,5005,2789,5005,971,4034,3917,2276,1159,12,457,0,13,117,3948,701,3247,3167,1921,871,11,357,0,7,80,2789,2427,362,12661844.419916,15893.838886
624,48,201,421900,2690,1127,2690,233,2457,2437,2261,50,3,112,0,11,20,2049,151,1898,1887,1754,39,3,84,0,7,11,1127,1083,44,18077871.609747,18813.749067
625,48,201,422000,2539,1081,2539,330,2209,2176,1924,102,7,137,0,6,33,1994,226,1768,1750,1556,75,5,110,0,4,18,1081,1040,41,15737200.554543,15869.867364
626,48,201,422100,5289,2046,5289,2264,3025,2952,1885,802,12,243,4,6,73,3996,1480,2516,2467,1650,597,10,202,3,5,49,2046,1905,141,25617867.390727,23874.580479
627,48,201,422200,4421,2674,4421,1007,3414,3365,129,3176,6,45,0,9,49,3010,636,2374,2343,116,2176,6,39,0,6,31,2674,1778,896,18909835.549256,17644.044519
628,48,201,422301,7108,2885,7108,2026,5082,4960,202,4056,9,675,6,12,122,4787,1316,3471,3402,168,2758,3,459,6,8,69,2885,2404,481,9748574.455429,13544.087542
629,48,201,422302,2350,974,2350,619,1731,1708,372,1234,2,97,0,3,23,1748,441,1307,1295,335,872,2,85,0,1,12,974,908,66,7472604.288798,11205.922803
630,48,201,422401,3910,1913,3910,1291,2619,2590,450,1923,7,201,0,9,29,2826,826,2000,1983,417,1374,7,180,0,5,17,1913,1685,228,8922800.842026,12268.331309
631,48,201,422402,6074,2165,6074,3774,2300,2260,1209,813,20,205,3,10,40,4215,2417,1798,1778,1034,563,15,158,3,5,20,2165,1980,185,14650316.142432,19088.861676
632,48,201,422500,5647,2682,5647,2311,3336,3255,1759,1124,7,336,0,29,81,4027,1415,2612,2560,1491,815,4,237,0,13,52,2682,2116,566,20024359.74225,18215.252037
633,48,201,422600,6380,2649,6380,3039,3341,3272,2394,694,6,159,1,18,69,4751,1982,2769,2728,2058,520,6,136,1,7,41,2649,2327,322,24544481.496303,20780.499166
634,48,201,422701,5083,1677,5083,3532,1551,1517,858,483,6,155,0,15,34,3569,2335,1234,1216,747,323,4,131,0,11,18,1677,1580,97,19775378.555939,21455.989306
635,48,201,422702,3347,1116,3347,2048,1299,1252,886,167,11,179,1,8,47,2530,1437,1093,1062,785,111,7,152,1,6,31,1116,1056,60,13840223.288771,15192.698672
636,48,201,422800,4916,1717,4916,2510,2406,2349,1397,681,12,249,2,8,57,3826,1665,2161,2128,1320,568,8,224,2,6,33,1717,1376,341,24758453.314165,20888.06986
637,48,201,422900,5027,2040,5027,2991,2036,1975,584,1204,15,166,0,6,61,3550,1958,1592,1545,527,863,10,142,0,3,47,2040,1827,213,17550062.478576,19893.673381
638,48,201,423000,4695,2355,4695,2969,1726,1688,543,1042,5,71,1,26,38,3345,1932,1413,1388,484,819,5,66,1,13,25,2355,1782,573,19864097.371456,20113.241741
639,48,201,423100,3161,1139,3161,2179,982,970,55,889,1,19,1,5,12,2037,1384,653,649,48,586,0,11,1,3,4,1139,1013,126,17793695.331939,23915.864102
640,48,201,423201,3233,1071,3233,1306,1927,1886,728,970,1,177,1,9,41,2370,860,1510,1480,639,684,1,152,1,3,30,1071,1023,48,21049647.527978,20478.866595
641,48,201,423202,6989,3108,6989,3288,3701,3627,470,2909,9,233,0,6,74,4833,2182,2651,2607,389,2016,8,193,0,1,44,3108,2586,522,15670654.422939,17142.820293
642,48,201,423301,3701,2052,3701,1072,2629,2595,1321,1059,8,187,2,18,34,2835,706,2129,2107,1151,785,6,158,2,5,22,2052,1561,491,18046236.009937,19497.758535
643,48,201,423302,5123,2404,5123,681,4442,4370,1016,3049,8,278,0,19,72,3950,470,3480,3429,862,2301,6,245,0,15,51,2404,2240,164,22010833.931424,19353.39759
644,48,201,423401,5153,1912,5153,905,4248,4188,873,3010,5,278,9,13,60,3680,573,3107,3070,598,2217,3,244,2,6,37,1912,1799,113,24456133.079759,21204.793546
645,48,201,423402,4207,1359,4207,892,3315,3273,157,2278,2,833,0,3,42,2997,586,2411,2388,150,1574,2,662,0,0,23,1359,1322,37,16508555.15613,18230.58061
646,48,201,423500,1927,722,1927,404,1523,1495,615,581,1,286,0,12,28,1498,268,1230,1209,532,440,1,232,0,4,21,722,698,24,13394140.220715,15867.411264
647,48,201,423600,6971,2292,6971,2426,4545,4486,658,3427,19,365,1,16,59,4994,1588,3406,3362,603,2431,12,303,1,12,44,2292,2165,127,35483254.29506,27567.265359
648,48,201,430100,5749,3464,5749,937,4812,4715,4030,220,3,449,1,12,97,4816,722,4094,4033,3486,179,2,354,1,11,61,3464,2950,514,46753012.574027,37468.011609
649,48,201,430200,1380,796,1380,256,1124,1107,940,31,4,126,0,6,17,1109,187,922,907,781,25,4,94,0,3,15,796,706,90,7622715.76434,16481.129603
650,48,201,430300,4367,1503,4367,197,4170,4108,3788,46,10,263,0,1,62,3063,139,2924,2895,2652,23,7,212,0,1,29,1503,1443,60,54771062.823784,39362.206076
651,48,201,430400,3125,1124,3125,142,2983,2933,2540,46,2,344,1,0,50,2338,105,2233,2204,1890,32,2,279,1,0,29,1124,1064,60,59511397.338118,40965.729627
652,48,201,430500,2557,1042,2557,281,2276,2208,1766,33,5,395,3,6,68,1822,177,1645,1610,1312,22,5,266,3,2,35,1042,975,67,24975425.487972,26730.259847
653,48,201,430600,3633,1259,3633,202,3431,3389,3000,11,4,354,2,18,42,2547,118,2429,2410,2132,7,2,259,2,8,19,1259,1207,52,40341057.437733,35605.367989
654,48,201,430700,3284,1673,3284,310,2974,2942,2280,55,9,587,0,11,32,2498,227,2271,2249,1795,39,8,402,0,5,22,1673,1542,131,19476467.3211,23671.641471
655,48,201,430800,4348,2084,4348,268,4080,4022,3340,48,8,611,10,5,58,3120,174,2946,2907,2423,38,8,426,8,4,39,2084,1706,378,35629284.23717,24979.080883
656,48,201,430900,5770,2767,5770,461,5309,5217,4263,46,10,884,1,13,92,4532,343,4189,4119,3470,32,6,603,1,7,70,2767,2606,161,30562462.810909,41767.409374
657,48,201,431000,5239,2654,5239,536,4703,4640,4065,176,9,380,2,8,63,4339,411,3928,3887,3429,136,9,307,2,4,41,2654,2453,201,45046881.623658,30956.173335
658,48,201,431101,3303,2274,3303,720,2583,2489,1663,581,2,224,1,18,94,2977,590,2387,2312,1579,519,2,195,1,16,75,2274,1977,297,9016019.862165,17984.538287
659,48,201,431102,3336,2262,3336,604,2732,2668,1663,632,9,342,0,22,64,2949,485,2464,2412,1544,526,9,318,0,15,52,2262,2000,262,10189155.011473,14910.536231
660,48,201,431201,4058,2479,4058,1037,3021,2907,1751,629,5,508,0,14,114,3541,812,2729,2642,1629,546,1,452,0,14,87,2479,2263,216,7213656.098513,12155.131162
661,48,201,431202,4592,2805,4592,884,3708,3622,2398,534,12,666,1,11,86,3901,724,3177,3119,2091,456,11,552,1,8,58,2805,2483,322,14133762.462149,18011.365402
662,48,201,431301,4516,2898,4516,1294,3222,3120,2138,573,15,377,1,16,102,3911,1049,2862,2786,1976,469,12,313,0,16,76,2898,2630,268,8111072.942151,12817.013494
663,48,201,431302,3929,2004,3929,412,3517,3460,3135,115,1,197,0,12,57,2992,296,2696,2655,2391,93,1,160,0,10,41,2004,1793,211,14282955.212672,15429.072065
664,48,201,431401,2339,1753,2339,539,1800,1749,1362,152,3,220,4,8,51,2080,440,1640,1596,1268,128,3,189,4,4,44,1753,1504,249,3895178.359397,10603.369995
665,48,201,431402,3209,2356,3209,445,2764,2691,2093,180,2,399,0,17,73,2957,393,2564,2500,1991,157,2,337,0,13,64,2356,2075,281,7715417.429907,12612.2086
666,48,201,431501,3711,2783,3711,424,3287,3220,2795,86,6,323,2,8,67,3381,370,3011,2962,2597,77,5,275,2,6,49,2783,2463,320,11191535.384775,14406.930251
667,48,201,431502,3471,1953,3471,310,3161,3119,2818,47,2,248,0,4,42,2867,239,2628,2599,2353,38,2,204,0,2,29,1953,1796,157,11967227.98543,14386.813168
668,48,201,431600,3352,1744,3352,224,3128,3103,2981,41,12,61,0,8,25,2844,180,2664,2647,2546,37,8,51,0,5,17,1744,1581,163,31740718.439395,36583.319697
669,48,201,431700,4591,2628,4591,372,4219,4144,3845,90,1,207,0,1,75,3936,282,3654,3605,3358,75,1,170,0,1,49,2628,2241,387,32123525.726186,28248.671591
670,48,201,431801,2967,1804,2967,314,2653,2607,1899,76,5,616,0,11,46,2538,266,2272,2239,1647,71,1,510,0,10,33,1804,1591,213,13176423.092355,14374.481397
671,48,201,431802,3695,3057,3695,630,3065,2991,2246,237,10,481,1,16,74,3375,546,2829,2771,2084,211,9,454,1,12,58,3057,2385,672,14671226.90387,17857.225446
672,48,201,431900,3786,2976,3786,634,3152,3089,2236,300,2,540,2,9,63,3557,582,2975,2927,2146,275,2,493,2,9,48,2976,2479,497,13780422.620265,18265.330185
673,48,201,432001,3464,2092,3464,905,2559,2491,1571,429,0,468,2,21,68,2903,709,2194,2147,1379,380,0,371,2,15,47,2092,1780,312,15505277.850014,18154.777401
674,48,201,432002,4734,2784,4734,2569,2165,2060,994,808,10,235,1,12,105,3952,2025,1927,1837,884,724,7,211,1,10,90,2784,2343,441,7587272.525313,11417.787208
675,48,201,432100,5054,2487,5054,1963,3091,2972,1487,902,16,547,2,18,119,4098,1504,2594,2506,1247,771,9,466,2,11,88,2487,2286,201,17256902.537058,17892.954574
676,48,201,432200,4043,2105,4043,1401,2642,2572,1570,688,4,307,0,3,70,3344,1083,2261,2210,1374,556,4,273,0,3,51,2105,1938,167,18021038.901143,18068.77757
677,48,201,432300,6521,3652,6521,2412,4109,3991,1001,2413,30,521,5,21,118,5087,1739,3348,3275,921,1868,24,443,5,14,73,3652,3197,455,18854405.738798,18730.29094
678,48,201,432400,5548,3233,5548,2124,3424,3305,940,1921,7,412,0,25,119,4355,1538,2817,2730,826,1517,3,366,0,18,87,3233,2810,423,19824479.44587,18288.20759
679,48,201,432500,5529,2647,5529,2904,2625,2555,1055,1227,4,247,0,22,70,4073,1980,2093,2050,895,938,2,202,0,13,43,2647,2276,371,18113892.949674,17861.542762
680,48,201,432600,1888,902,1888,543,1345,1321,843,389,4,76,3,6,24,1435,370,1065,1048,687,292,4,60,3,2,17,902,805,97,17755364.139097,18569.789214
681,48,201,432701,6721,2589,6721,5912,809,794,383,319,18,66,1,7,15,5024,4373,651,641,303,259,14,60,1,4,10,2589,2017,572,12535955.622435,16207.800793
682,48,201,432702,3384,1537,3384,1793,1591,1556,1185,191,3,165,1,11,35,2658,1268,1390,1362,1035,172,3,144,1,7,28,1537,1445,92,12392508.386032,17449.203167
683,48,201,432801,4767,2322,4767,2428,2339,2280,589,1255,12,402,1,21,59,3437,1636,1801,1759,478,912,8,343,1,17,42,2322,1877,445,23949171.515046,23514.450117
684,48,201,432802,5616,2795,5616,3750,1866,1813,580,757,5,460,1,10,53,4161,2565,1596,1557,544,579,5,423,1,5,39,2795,2193,602,13937276.471812,15133.487874
685,48,201,432901,3484,1214,3484,2596,888,870,336,370,2,143,0,19,18,2421,1712,709,696,287,268,2,129,0,10,13,1214,1109,105,15508561.356693,21813.713154
686,48,201,432902,4476,2518,4476,2473,2003,1964,598,620,5,728,12,1,39,3345,1713,1632,1606,515,454,3,624,10,0,26,2518,1649,869,16391493.523102,17771.804523
687,48,201,433001,5358,2013,5358,3270,2088,2014,183,337,6,1463,18,7,74,3738,2232,1506,1447,160,287,3,978,15,4,59,2013,1662,351,13335119.007226,16424.675746
688,48,201,433002,4859,1973,4859,3495,1364,1350,113,505,8,716,2,6,14,3555,2492,1063,1051,84,361,6,595,2,3,12,1973,1623,350,6924098.439492,10769.49571
689,48,201,433003,4831,2081,4831,2216,2615,2554,112,751,11,1679,0,1,61,3398,1390,2008,1967,81,439,11,1435,0,1,41,2081,1757,324,9955177.659799,13112.964312
690,48,201,433100,3748,1356,3748,2568,1180,1151,69,967,5,93,0,17,29,2258,1462,796,778,48,632,3,87,0,8,18,1356,1109,247,9210582.482467,14817.644337
691,48,201,433201,5118,2090,5118,1706,3412,3348,675,1199,5,1455,2,12,64,3846,1133,2713,2667,628,810,3,1220,2,4,46,2090,1892,198,11797769.878721,15038.997337
692,48,201,433202,4336,1410,4336,2432,1904,1864,639,297,4,916,0,8,40,3059,1527,1532,1509,567,194,3,744,0,1,23,1410,1282,128,12376482.787349,15744.977133
693,48,201,433300,5196,1802,5196,2052,3144,3079,1713,334,2,1021,1,8,65,4066,1412,2654,2622,1520,240,2,853,1,6,32,1802,1717,85,26069029.65584,20542.737651
694,48,201,433400,4406,1854,4406,2511,1895,1844,469,982,3,380,0,10,51,3271,1753,1518,1491,417,734,2,331,0,7,27,1854,1692,162,18076235.609446,17878.539928
695,48,201,433501,6161,2104,6161,4785,1376,1354,150,1141,1,56,0,6,22,4152,3226,926,917,113,754,1,47,0,2,9,2104,1924,180,13451593.86064,23970.945364
696,48,201,433502,7116,3115,7116,5463,1653,1616,141,1082,3,380,0,10,37,4732,3516,1216,1197,111,781,3,297,0,5,19,3115,2415,700,8645983.546775,12840.755539
697,48,201,433600,5281,2891,5281,2050,3231,3172,226,2603,12,322,0,9,59,3621,1314,2307,2268,201,1779,7,273,0,8,39,2891,2066,825,15435343.008611,18180.422318
698,48,201,440100,6751,2736,6751,2926,3825,3741,1034,2213,6,471,5,12,84,5084,2108,2976,2916,892,1602,6,404,5,7,60,2736,2383,353,58959222.967479,42980.713435
699,48,201,450100,1756,780,1756,168,1588,1559,1295,22,0,239,2,1,29,1267,110,1157,1145,977,13,0,154,1,0,12,780,730,50,8791525.058634,13238.790273
700,48,201,450200,4872,1807,4872,306,4566,4502,3969,49,8,468,1,7,64,3317,189,3128,3099,2743,42,4,306,1,3,29,1807,1698,109,28043261.650273,25285.337052
701,48,201,450300,7024,3047,7024,1979,5045,4847,2732,1349,24,724,2,16,198,5000,1230,3770,3645,2260,798,13,563,2,9,125,3047,2651,396,27056921.482358,20629.711605
702,48,201,450400,4503,2359,4503,1011,3492,3375,2277,611,8,446,2,31,117,3518,698,2820,2746,1922,437,8,358,2,19,74,2359,2041,318,20441839.833497,19622.689362
703,48,201,450500,2941,1268,2941,248,2693,2647,2286,58,1,297,0,5,46,2426,175,2251,2215,1920,42,1,247,0,5,36,1268,1224,44,30909866.020898,24273.878707
704,48,201,450600,4310,1933,4310,838,3472,3391,2763,314,6,298,0,10,81,3250,553,2697,2653,2185,210,5,246,0,7,44,1933,1786,147,20305811.71744,21117.132224
705,48,201,450700,6461,2341,6461,362,6099,6003,5646,20,6,326,2,3,96,4628,248,4380,4339,4080,14,5,235,2,3,41,2341,2270,71,47775853.321407,39138.198852
706,48,201,450801,2170,1240,2170,486,1684,1643,1090,411,6,134,0,2,41,1850,379,1471,1447,990,329,6,121,0,1,24,1240,1157,83,9903559.708026,18862.079741
707,48,201,450802,5991,3345,5991,2002,3989,3886,2060,1452,5,354,0,15,103,4344,1269,3075,3009,1687,996,4,310,0,12,66,3345,2263,1082,18495168.035636,19660.430252
708,48,201,450900,2434,1198,2434,426,2008,1969,1563,184,4,210,2,6,39,1975,307,1668,1640,1316,144,4,168,2,6,28,1198,1114,84,17458565.134694,16982.871875
709,48,201,451001,4981,2660,4981,1737,3244,3171,1504,1345,4,301,0,17,73,3836,1200,2636,2588,1298,1008,4,271,0,7,48,2660,2305,355,14187885.645908,16090.72599
710,48,201,451002,5109,2636,5109,1491,3618,3526,932,2329,10,224,14,17,92,3770,1030,2740,2676,832,1616,10,198,9,11,64,2636,2298,338,6456799.547172,12751.615468
711,48,201,451100,3989,2227,3989,912,3077,3010,2312,408,6,275,1,8,67,3328,642,2686,2640,2075,320,5,231,1,8,46,2227,2012,215,26439612.846697,22277.474216
712,48,201,451200,2675,1127,2675,280,2395,2354,2169,59,2,118,0,6,41,2193,215,1978,1951,1810,45,2,91,0,3,27,1127,1092,35,18439771.067435,20126.124305
713,48,201,451300,6881,3239,6881,1201,5680,5498,3864,1115,30,463,5,21,182,5503,902,4601,4488,3233,831,19,388,5,12,113,3239,3070,169,33178332.585634,22940.080893
714,48,201,451401,3330,1818,3330,718,2612,2572,1663,566,7,320,0,16,40,2677,510,2167,2142,1431,427,7,267,0,10,25,1818,1679,139,11674431.72717,13951.741673
715,48,201,451402,4543,2586,4543,1384,3159,3070,1355,1445,7,229,3,31,89,3555,992,2563,2503,1204,1077,6,198,3,15,60,2586,2324,262,14870287.201592,15555.36531
716,48,201,451403,3504,2290,3504,773,2731,2644,1341,808,11,473,1,10,87,2848,582,2266,2208,1158,657,7,382,1,3,58,2290,1853,437,12662925.453724,18263.525351
717,48,201,451500,5084,3276,5084,911,4173,4072,2336,788,10,928,1,9,101,4354,737,3617,3539,2132,651,7,741,1,7,78,3276,2922,354,21876593.736426,22951.229969
718,48,201,451601,5886,2770,5886,687,5199,5087,3756,252,4,1057,1,17,112,4663,479,4184,4126,3180,178,3,753,1,11,58,2770,2571,199,36127052.449669,25543.522065
719,48,201,451602,7317,3226,7317,1354,5963,5756,3401,687,21,1620,5,22,207,5549,960,4589,4470,2697,524,14,1211,5,19,119,3226,2965,261,46010916.063472,26968.545064
720,48,201,451700,3407,1666,3407,792,2615,2540,886,1270,5,372,1,6,75,2618,558,2060,2018,797,899,4,314,1,3,42,1666,1469,197,18908064.478857,20794.911417
721,48,201,451800,4748,2004,4748,1780,2968,2855,989,1239,13,599,3,12,113,3540,1230,2310,2237,843,855,8,520,3,8,73,2004,1730,274,51529407.444157,29555.236318
722,48,201,451901,7411,3535,7411,2413,4998,4890,1136,3081,6,652,2,13,108,5535,1653,3882,3805,997,2244,4,550,1,9,77,3535,3121,414,22373584.71398,19193.831528
723,48,201,451902,2466,891,2466,283,2183,2139,841,175,0,1119,0,4,44,1885,209,1676,1647,659,120,0,864,0,4,29,891,854,37,22327154.11521,19540.401845
724,48,201,452000,7136,3723,7136,1840,5296,5076,1732,2396,17,913,2,16,220,5630,1367,4263,4114,1522,1820,9,751,2,10,149,3723,3248,475,21125651.693349,22258.228968
725,48,201,452100,8823,4919,8823,1799,7024,6830,3025,2595,20,1170,0,20,194,7244,1350,5894,5756,2693,2043,16,984,0,20,138,4919,4444,475,49048249.584814,28089.036245
726,48,201,452201,5215,3192,5215,1803,3412,3282,855,2002,10,403,4,8,130,4191,1321,2870,2782,790,1626,8,350,2,6,88,3192,2818,374,14665798.453755,15521.519546
727,48,201,452202,2963,1725,2963,848,2115,2055,649,965,6,422,2,11,60,2429,645,1784,1742,600,765,5,361,2,9,42,1725,1524,201,16462707.253041,16282.749118
728,48,201,452300,2323,730,2323,1052,1271,1239,157,394,1,680,0,7,32,1719,693,1026,1001,138,279,1,577,0,6,25,730,685,45,21407440.32254,18512.735197
729,48,201,452400,8192,2649,8192,3759,4433,4348,713,1535,3,2081,1,15,85,5840,2507,3333,3285,641,973,2,1659,1,9,48,2649,2503,146,23960766.796062,19721.607425
730,48,201,452500,7794,2681,7794,3189,4605,4519,605,2085,19,1801,1,8,86,5255,2031,3224,3181,527,1267,14,1368,1,4,43,2681,2390,291,33797629.087863,24839.02147
731,48,201,452600,7130,2553,7130,2226,4904,4798,427,2469,6,1873,2,21,106,4745,1403,3342,3290,341,1466,5,1461,2,15,52,2553,2056,497,28344067.920252,24828.312816
732,48,201,452700,9901,3333,9901,2684,7217,7071,496,2988,16,3530,7,34,146,7020,1768,5252,5161,403,1946,9,2781,3,19,91,3333,3074,259,49681036.894977,29500.802477
733,48,201,452801,5553,1987,5553,1688,3865,3752,606,1788,5,1347,1,5,113,4045,1116,2929,2861,539,1227,5,1084,1,5,68,1987,1818,169,17231467.301802,17198.665172
734,48,201,452802,5949,1933,5949,2923,3026,2960,226,1492,9,1222,1,10,66,3946,1813,2133,2095,194,910,6,980,1,4,38,1933,1753,180,13975577.73697,15861.850575
735,48,201,452900,4040,1263,4040,2195,1845,1808,438,618,5,736,1,10,37,2826,1421,1405,1381,385,394,4,591,1,6,24,1263,1150,113,14153603.423767,15951.078888
736,48,201,453000,7857,2203,7857,5272,2585,2522,599,802,7,1092,1,21,63,5387,3387,2000,1952,537,483,4,914,1,13,48,2203,2033,170,29485053.977673,21900.047893
737,48,201,453100,3266,1658,3266,1745,1521,1482,213,753,5,497,4,10,39,2293,1109,1184,1157,190,527,3,428,3,6,27,1658,1148,510,23873066.085947,19678.809513
738,48,201,453200,7947,2862,7947,4342,3605,3508,506,2094,20,867,6,15,97,5382,2685,2697,2631,429,1473,18,699,5,7,66,2862,2620,242,18964576.509604,17947.029066
739,48,201,453300,2965,1299,2965,621,2344,2289,114,1506,3,652,1,13,55,2034,396,1638,1599,106,949,3,532,1,8,39,1299,1139,160,22223426.173109,21735.55216
740,48,201,453401,3125,1087,3125,1818,1307,1275,461,462,16,331,3,2,32,2241,1188,1053,1033,411,334,11,272,3,2,20,1087,1021,66,10301240.391294,13795.274351
741,48,201,453402,8214,2806,8214,4221,3993,3869,577,1760,17,1496,3,16,124,5676,2688,2988,2898,513,1198,11,1166,2,8,90,2806,2546,260,25901913.418586,20605.880635
742,48,201,453403,3133,1586,3133,1171,1962,1947,131,1271,7,530,0,8,15,2193,737,1456,1445,110,883,6,439,0,7,11,1586,1106,480,7359619.782918,11866.587542
743,48,201,453501,6174,2150,6174,2418,3756,3624,484,1646,10,1464,1,19,132,4345,1532,2813,2730,400,1103,4,1212,1,10,83,2150,1931,219,16194126.717412,20305.989177
744,48,201,453502,3685,1135,3685,1596,2089,2046,448,1168,5,416,1,8,43,2542,1020,1522,1503,399,753,2,343,1,5,19,1135,1052,83,14064985.387719,16728.612954
745,48,201,453601,2108,744,2108,936,1172,1139,159,703,2,267,0,8,33,1401,591,810,791,144,424,1,215,0,7,19,744,632,112,12920009.48532,15056.193336
746,48,201,453602,7699,2478,7699,3922,3777,3682,583,1846,4,1239,2,8,95,5424,2534,2890,2831,540,1262,4,1020,1,4,59,2478,2235,243,27534894.505421,21122.171676
747,48,201,453700,8194,2829,8194,3305,4889,4797,678,2947,11,1153,1,7,92,5706,2172,3534,3474,600,1933,10,927,1,3,60,2829,2446,383,25114548.542762,22650.837793
748,48,201,453800,3342,1096,3342,1414,1928,1885,550,912,5,414,1,3,43,2389,900,1489,1465,492,609,5,358,1,0,24,1096,1024,72,19547039.859071,24464.04588
749,48,201,453900,10151,2967,10151,3397,6754,6614,587,2614,13,3384,0,16,140,6990,2169,4821,4733,476,1661,10,2578,0,8,88,2967,2835,132,35077001.676601,26561.256433
750,48,201,454000,5041,1467,5041,1779,3262,3161,582,1503,3,1048,3,22,101,3638,1212,2426,2365,486,1019,2,845,3,10,61,1467,1403,64,22442096.264454,22130.670959
751,48,201,454100,3480,1111,3480,1228,2252,2203,542,1095,5,546,1,14,49,2451,785,1666,1635,475,731,3,416,1,9,31,1111,1035,76,18695193.9517,18498.365576
752,48,201,454200,3966,1199,3966,2096,1870,1831,685,879,9,237,5,16,39,2803,1370,1433,1416,570,626,5,203,4,8,17,1199,1141,58,15359838.561019,18802.428826
753,48,201,454301,10503,4753,10503,3327,7176,6997,1655,3995,18,1292,1,36,179,7608,2285,5323,5212,1392,2741,14,1034,1,30,111,4753,3915,838,42625848.229202,26960.112582
754,48,201,454302,6490,2285,6490,2570,3920,3809,1405,1453,23,917,0,11,111,4757,1724,3033,2966,1214,1021,15,709,0,7,67,2285,2186,99,30000403.680633,25397.212535
755,48,201,454400,282,335,282,42,240,240,142,54,1,40,0,3,0,218,27,191,191,123,39,1,25,0,3,0,335,134,201,363834389.905194,85230.04972
756,48,201,454501,8423,2927,8423,661,7762,7657,5751,186,8,1683,4,25,105,6143,476,5667,5621,4290,141,6,1171,4,9,46,2927,2862,65,123099529.061526,46682.417952
757,48,201,454502,2553,776,2553,371,2182,2136,1307,128,3,693,2,3,46,1711,233,1478,1459,894,90,2,469,2,2,19,776,757,19,81502846.888045,40341.570626
758,48,201,454600,4765,2163,4765,1006,3759,3646,2958,328,13,332,5,10,113,3639,701,2938,2886,2382,244,9,242,2,7,52,2163,2053,110,35526094.309523,28128.980045
759,48,201,454700,6762,2500,6762,737,6025,5869,5231,228,21,373,2,14,156,5143,497,4646,4553,4039,170,19,316,2,7,93,2500,2411,89,37583625.886779,24788.84515
760,48,201,454800,7313,2877,7313,1853,5460,5346,4444,500,42,319,9,32,114,5432,1246,4186,4129,3470,351,30,254,6,18,57,2877,2781,96,31635223.68845,22744.74768
761,48,201,454900,10460,3303,10460,2038,8422,8229,5400,698,24,2078,3,26,193,7035,1306,5729,5640,3728,444,12,1442,3,11,89,3303,3208,95,49932996.497614,28573.099068
762,48,201,455000,2838,1049,2838,346,2492,2446,1992,155,6,289,0,4,46,2055,253,1802,1779,1470,107,5,195,0,2,23,1049,1008,41,14098883.180935,17810.057355
763,48,201,455101,7051,2560,7051,1856,5195,5091,4466,338,31,239,2,15,104,5026,1190,3836,3787,3313,252,21,192,2,7,49,2560,2458,102,29401436.746254,27784.350308
764,48,201,455102,3226,1071,3226,544,2682,2617,2276,147,18,169,4,3,65,2270,359,1911,1874,1634,106,11,118,4,1,37,1071,1050,21,16937997.029746,23543.300481
765,48,201,455200,4472,1579,4472,1070,3402,3342,3033,180,15,104,1,9,60,3293,683,2610,2580,2358,122,9,86,1,4,30,1579,1525,54,29464191.68665,23640.175516
766,48,201,455300,3290,1394,3290,886,2404,2329,1513,547,9,254,1,5,75,2312,576,1736,1691,1149,347,7,183,1,4,45,1394,1259,135,59742892.235228,34836.126878
767,48,201,510100,2142,1049,2142,969,1173,1160,762,322,9,62,0,5,13,1881,770,1111,1098,720,306,9,59,0,4,13,1049,882,167,16082876.939813,17475.567657
768,48,201,510200,5432,3307,5432,1512,3920,3819,3084,373,18,328,8,8,101,4903,1226,3677,3602,2943,331,16,299,5,8,75,3307,3067,240,38572518.234476,30374.051792
769,48,201,510300,5284,2878,5284,1346,3938,3846,3574,123,15,119,3,12,92,4361,1018,3343,3289,3053,110,14,102,3,7,54,2878,2585,293,25986542.659414,22505.030688
770,48,201,510400,3837,2229,3837,1002,2835,2759,2576,92,5,77,0,9,76,3261,792,2469,2424,2263,82,5,69,0,5,45,2229,2017,212,15992538.638603,16321.751342
771,48,201,510500,2849,1523,2849,1031,1818,1769,1415,265,3,76,0,10,49,2330,733,1597,1565,1254,229,3,70,0,9,32,1523,1297,226,18942243.795006,17575.370698
772,48,201,510600,4763,2521,4763,1859,2904,2848,2204,303,7,319,2,13,56,4112,1455,2657,2609,2051,253,7,286,2,10,48,2521,2248,273,22483431.294905,23951.506616
773,48,201,510700,3511,2286,3511,720,2791,2721,2252,136,12,312,0,9,70,3214,616,2598,2542,2122,119,12,281,0,8,56,2286,2108,178,11778413.086575,13943.380458
774,48,201,510800,6908,4123,6908,1028,5880,5782,5032,260,13,466,1,10,98,6206,847,5359,5294,4643,228,9,406,1,7,65,4123,3810,313,95826831.39955,50727.699263
775,48,201,510900,6070,2921,6070,2830,3240,3160,2578,188,16,359,0,19,80,4979,2052,2927,2876,2361,166,16,322,0,11,51,2921,2679,242,58430201.394418,37898.188985
776,48,201,511001,2685,1498,2685,594,2091,2046,1836,117,12,76,0,5,45,2315,456,1859,1824,1630,107,9,73,0,5,35,1498,1404,94,24352622.644131,23016.258796
777,48,201,511002,4261,2449,4261,1280,2981,2929,2475,287,17,141,1,8,52,3602,980,2622,2590,2202,248,15,118,1,6,32,2449,2276,173,22797061.743988,21055.841689
778,48,201,511100,2676,1548,2676,912,1764,1726,1339,276,6,101,1,3,38,2304,690,1614,1595,1242,251,6,92,1,3,19,1548,1262,286,20383471.363363,23649.647069
779,48,201,511200,4424,2293,4424,1419,3005,2947,2533,242,9,157,1,5,58,3767,1055,2712,2670,2301,219,8,137,1,4,42,2293,2098,195,22603595.863877,21075.85683
780,48,201,511301,3970,2090,3970,1280,2690,2638,2410,117,7,92,3,9,52,3256,938,2318,2289,2104,95,7,75,3,5,29,2090,1903,187,19454766.454684,17939.158734
781,48,201,511302,3631,2199,3631,710,2921,2865,2720,79,0,59,0,7,56,3100,577,2523,2487,2356,71,0,54,0,6,36,2199,1942,257,17095512.403604,16729.339702
782,48,201,511400,3001,1633,3001,1183,1818,1774,1706,31,3,32,0,2,44,2482,858,1624,1598,1539,26,2,29,0,2,26,1633,1480,153,12334219.955964,17781.049653
783,48,201,511500,6472,3182,6472,2978,3494,3414,3118,157,13,113,1,12,80,5265,2193,3072,3017,2765,134,12,95,1,10,55,3182,2822,360,33152935.587428,26432.337014
784,48,201,511600,4641,1773,4641,3683,958,931,797,63,3,55,7,6,27,3430,2555,875,855,741,55,2,48,3,6,20,1773,1576,197,20979341.364435,21133.214674
785,48,201,520100,1597,934,1597,856,741,727,631,38,3,53,0,2,14,1241,611,630,619,547,28,3,41,0,0,11,934,603,331,32798173.995982,23713.372239
786,48,201,520200,3604,1558,3604,1191,2413,2383,2040,134,7,199,0,3,30,2564,759,1805,1792,1556,84,5,146,0,1,13,1558,1401,157,20607049.313497,18505.357268
787,48,201,520300,5126,1962,5126,3339,1787,1740,1352,200,10,169,2,7,47,3780,2224,1556,1525,1201,168,7,140,2,7,31,1962,1784,178,15928876.127598,16516.515906
788,48,201,520400,3079,1073,3079,2475,604,593,438,128,4,23,0,0,11,2204,1652,552,546,413,109,3,21,0,0,6,1073,968,105,21989171.659731,21680.814614
789,48,201,520500,7869,2795,7869,6084,1785,1725,1218,410,18,56,0,23,60,5471,3938,1533,1501,1101,327,16,43,0,14,32,2795,2473,322,80987820.664072,56678.862453
790,48,201,520601,2484,818,2484,1960,524,519,275,33,3,204,0,4,5,1733,1280,453,449,241,26,3,175,0,4,4,818,734,84,21144946.58468,18643.062946
791,48,201,520602,6272,2145,6272,5132,1140,1108,877,140,8,77,1,5,32,4279,3284,995,973,787,114,6,64,1,1,22,2145,1879,266,14498604.316158,15822.83312
792,48,201,520700,3724,1444,3724,1492,2232,2192,1898,134,6,145,1,8,40,2770,1015,1755,1737,1501,117,6,106,1,6,18,1444,1298,146,21162356.913755,21267.694239
793,48,201,521000,2103,761,2103,1407,696,682,563,90,2,22,1,4,14,1414,880,534,526,450,53,2,18,1,2,8,761,645,116,12383772.510071,19143.215272
794,48,201,521100,2177,717,2177,1778,399,390,341,12,0,36,0,1,9,1561,1236,325,321,282,9,0,30,0,0,4,717,633,84,6433944.529937,12183.178735
795,48,201,521200,6328,2359,6328,4719,1609,1571,1025,334,7,173,0,32,38,4437,3069,1368,1344,919,253,6,149,0,17,24,2359,2034,325,20203192.011426,20825.943354
796,48,201,521300,5439,1876,5439,3576,1863,1817,1200,279,5,326,1,6,46,3861,2308,1553,1525,1046,193,5,274,1,6,28,1876,1752,124,31851052.631663,24684.189518
797,48,201,521400,7593,2247,7593,6971,622,612,509,49,2,41,0,11,10,5039,4525,514,507,430,32,2,35,0,8,7,2247,2070,177,16358497.760224,16410.092438
798,48,201,521500,5897,1932,5897,3893,2004,1961,1534,164,8,238,3,14,43,4239,2549,1690,1667,1351,110,8,186,3,9,23,1932,1829,103,21887120.828335,18812.602817
799,48,201,521600,3632,1035,3632,2513,1119,1104,436,582,1,78,2,5,15,2428,1570,858,847,364,426,1,54,0,2,11,1035,956,79,71891726.935977,39867.158172
800,48,201,521700,6609,3240,6609,4281,2328,2254,789,1311,10,127,6,11,74,4727,2900,1827,1784,702,952,7,114,3,6,43,3240,2625,615,59244012.639735,49489.787194
801,48,201,521800,5778,1941,5778,2893,2885,2819,1099,495,5,1214,0,6,66,4355,1959,2396,2349,949,389,4,1005,0,2,47,1941,1830,111,77221650.657224,38018.540748
802,48,201,521900,6537,2554,6537,2703,3834,3761,2825,254,10,658,0,14,73,4987,1709,3278,3236,2469,176,9,571,0,11,42,2554,2302,252,41115135.921584,25756.100085
803,48,201,522000,4434,2118,4434,2387,2047,2020,1696,161,2,160,0,1,27,3502,1642,1860,1843,1564,131,2,145,0,1,17,2118,1867,251,22066085.519454,19373.290287
804,48,201,522100,7445,2856,7445,4197,3248,3186,2219,720,19,223,1,4,62,5269,2626,2643,2607,1943,462,17,181,1,3,36,2856,2603,253,24807194.970385,20546.399945
805,48,201,522201,3687,1351,3687,2413,1274,1254,940,172,4,129,1,8,20,2615,1559,1056,1049,815,118,3,111,0,2,7,1351,1163,188,17529422.178473,24156.279654
806,48,201,522202,3655,1354,3655,2344,1311,1284,906,224,8,130,0,16,27,2546,1469,1077,1061,785,147,5,114,0,10,16,1354,1117,237,19031798.748356,17265.768362
807,48,201,522301,4126,1602,4126,2568,1558,1512,1092,242,14,157,1,6,46,2959,1659,1300,1277,951,173,11,137,1,4,23,1602,1473,129,14913706.903678,16192.400737
808,48,201,522302,3909,1515,3909,2674,1235,1213,910,100,3,188,1,11,22,2948,1864,1084,1070,818,78,3,165,1,5,14,1515,1365,150,14588828.536949,15247.371236
809,48,201,522401,5259,2249,5259,2731,2528,2466,2110,129,11,183,4,29,62,3952,1840,2112,2071,1787,95,10,159,4,16,41,2249,1860,389,29776931.786747,26741.382205
810,48,201,522402,3920,1312,3920,2333,1587,1561,1313,112,12,103,5,16,26,2712,1388,1324,1305,1135,69,10,77,4,10,19,1312,1237,75,30863158.273364,26589.018309
811,48,201,522500,4461,1727,4461,335,4126,4078,3798,35,7,229,0,9,48,3232,208,3024,3000,2795,23,5,174,0,3,24,1727,1653,74,43433474.115341,32366.683297
812,48,201,530100,6233,2735,6233,4555,1678,1649,1010,587,4,32,0,16,29,4472,3016,1456,1431,917,473,4,29,0,8,25,2735,2267,468,28052886.800583,24163.855857
813,48,201,530200,3373,1674,3373,1245,2128,2086,1883,97,11,89,2,4,42,2715,889,1826,1798,1623,82,10,78,2,3,28,1674,1381,293,38218089.197899,37831.273331
814,48,201,530300,2400,1231,2400,689,1711,1692,38,1637,6,3,0,8,19,1833,395,1438,1424,34,1376,4,2,0,8,14,1231,948,283,19769181.371532,21905.678249
815,48,201,530400,2602,1075,2602,1103,1499,1490,121,1355,3,10,0,1,9,1981,701,1280,1274,114,1148,3,8,0,1,6,1075,914,161,17126390.687441,20995.80185
816,48,201,530500,4763,1848,4763,2429,2334,2321,206,2069,10,22,1,13,13,3442,1538,1904,1896,167,1690,7,22,1,9,8,1848,1513,335,25381179.669035,20751.787246
817,48,201,530600,3612,1396,3612,1908,1704,1677,545,1103,5,18,0,6,27,2673,1190,1483,1463,505,929,5,18,0,6,20,1396,1164,232,33228396.101362,30301.053313
818,48,201,530700,5606,1806,5606,3607,1999,1985,443,1518,5,13,0,6,14,3701,2305,1396,1390,394,977,4,13,0,2,6,1806,1660,146,30014746.299181,25291.854579
819,48,201,530800,3849,1706,3849,519,3330,3306,271,3016,9,8,0,2,24,3027,330,2697,2679,218,2444,8,7,0,2,18,1706,1519,187,49523456.562282,29772.610977
820,48,201,530900,4187,1753,4187,1531,2656,2618,2139,436,6,31,0,6,38,3222,1023,2199,2177,1813,326,6,27,0,5,22,1753,1628,125,21534528.292564,19227.344614
821,48,201,531000,3629,1665,3629,1093,2536,2489,2377,41,10,58,0,3,47,2834,748,2086,2060,1962,39,5,51,0,3,26,1665,1539,126,25679954.526876,21944.392501
822,48,201,531100,2854,1337,2854,954,1900,1869,1765,51,12,38,2,1,31,2286,650,1636,1617,1526,41,11,36,2,1,19,1337,1240,97,17771861.156838,18009.480009
823,48,201,531200,3162,1605,3162,1141,2021,1995,1661,263,7,56,4,4,26,2500,787,1713,1701,1467,170,7,52,1,4,12,1605,1381,224,20960975.27464,18752.230661
824,48,201,531300,5380,2511,5380,3240,2140,2087,1286,711,5,75,1,9,53,4015,2169,1846,1813,1167,566,5,68,1,6,33,2511,2136,375,16652168.490399,23679.340843
825,48,201,531400,2053,1015,2053,788,1265,1240,1161,39,4,36,0,0,25,1683,547,1136,1118,1051,32,4,31,0,0,18,1015,964,51,11463194.117693,18186.701554
826,48,201,531500,3020,1306,3020,1285,1735,1720,1443,202,6,66,0,3,15,2393,915,1478,1471,1265,141,6,58,0,1,7,1306,1235,71,20530477.690532,22296.679808
827,48,201,531600,2823,1240,2823,1024,1799,1761,1599,134,5,22,0,1,38,2218,687,1531,1511,1379,110,4,17,0,1,20,1240,1156,84,25582749.286913,21822.253646
828,48,201,531700,2829,1382,2829,532,2297,2265,2144,60,7,47,2,5,32,2307,389,1918,1899,1809,37,6,42,2,3,19,1382,1288,94,20044103.295305,18388.146933
829,48,201,531800,2352,905,2352,486,1866,1847,61,1775,8,1,0,2,19,1665,274,1391,1380,46,1323,8,1,0,2,11,905,783,122,35071689.748043,25906.853191
830,48,201,531900,4708,1624,4708,1042,3666,3641,65,3554,3,18,0,1,25,3261,647,2614,2595,47,2526,3,18,0,1,19,1624,1506,118,46894573.676831,30076.255402
831,48,201,532001,4867,3789,4867,1468,3399,3351,461,2830,13,40,0,7,48,3419,947,2472,2444,417,1981,9,33,0,4,28,3789,1994,1795,21174058.239663,23795.421682
832,48,201,532002,1008,431,1008,322,686,670,498,156,3,10,0,3,16,794,223,571,559,417,131,3,5,0,3,12,431,408,23,7064948.845558,11228.828264
833,48,201,532100,5777,2749,5777,2663,3114,3066,1325,1620,10,106,3,2,48,4172,1751,2421,2387,1147,1127,9,100,2,2,34,2749,2198,551,20392916.680699,18793.715418
834,48,201,532200,2790,1469,2790,1011,1779,1756,399,1326,6,20,0,5,23,1921,632,1289,1271,380,865,5,19,0,2,18,1469,1088,381,20176121.222037,19548.961198
835,48,201,532300,5520,2836,5520,2109,3411,3358,1460,1638,8,223,3,26,53,4180,1410,2770,2737,1300,1219,8,188,3,19,33,2836,2489,347,66793431.110737,36338.100779
836,48,201,532400,6112,2095,6112,3529,2583,2536,1575,750,20,180,1,10,47,4361,2271,2090,2063,1369,542,11,132,1,8,27,2095,1964,131,50459475.325146,42843.63596
837,48,201,532501,8895,2612,8895,5239,3656,3556,1625,701,11,1205,0,14,100,6147,3319,2828,2774,1354,491,8,910,0,11,54,2612,2526,86,51794900.957873,31242.354383
838,48,201,532502,5562,1535,5562,4276,1286,1255,720,406,7,108,0,14,31,3681,2658,1023,1001,630,271,3,90,0,7,22,1535,1467,68,29075367.115261,25982.112294
839,48,201,532600,6558,2341,6558,2637,3921,3873,503,2649,15,693,1,12,48,4527,1670,2857,2838,454,1825,12,538,1,8,19,2341,2016,325,28818091.670757,22877.123143
840,48,201,532700,4820,1954,4820,1559,3261,3212,1008,2054,14,123,2,11,49,3598,1038,2560,2530,926,1482,8,102,2,10,30,1954,1764,190,28941423.668241,22998.195298
841,48,201,532800,1684,718,1684,731,953,936,389,473,4,66,2,2,17,1242,484,758,748,353,336,3,53,2,1,10,718,613,105,14501292.287545,24416.350439
842,48,201,532900,4667,1620,4667,1941,2726,2703,271,2013,15,401,0,3,23,3230,1200,2030,2021,244,1416,12,347,0,2,9,1620,1370,250,18366646.900887,18338.135573
843,48,201,533000,2245,1050,2245,594,1651,1634,44,1547,14,28,0,1,17,1512,362,1150,1141,34,1075,12,20,0,0,9,1050,787,263,19072548.220711,19716.881527
844,48,201,533100,6449,2312,6449,1589,4860,4805,525,4163,19,94,0,4,55,4436,1004,3432,3403,472,2833,11,84,0,3,29,2312,2136,176,37756140.024284,29378.489775
845,48,201,533200,3222,1526,3222,651,2571,2537,182,2282,9,63,0,1,34,2357,418,1939,1917,168,1687,4,58,0,0,22,1526,1191,335,28828784.96794,28726.814733
846,48,201,533300,5880,2313,5880,913,4967,4918,61,4815,9,25,1,7,49,4247,586,3661,3634,50,3544,8,25,1,6,27,2313,2090,223,38126648.793731,26859.545598
847,48,201,533400,9655,2877,9655,5017,4638,4592,281,4137,7,147,2,18,46,6470,3059,3411,3389,239,3007,6,123,2,12,22,2877,2695,182,74027151.640054,49800.96782
848,48,201,533500,4383,1278,4383,2973,1410,1377,609,596,5,166,0,1,33,3062,1893,1169,1142,552,457,4,128,0,1,27,1278,1227,51,28762869.700532,27348.733322
849,48,201,533600,5480,1885,5480,3102,2378,2344,424,1732,12,165,1,10,34,3491,1875,1616,1597,371,1085,7,127,1,6,19,1885,1714,171,38022152.726544,28259.862027
850,48,201,533701,5695,1837,5695,4423,1272,1243,209,864,4,161,0,5,29,3684,2803,881,865,176,556,2,127,0,4,16,1837,1581,256,95896478.49067,45740.045004
851,48,201,533702,3498,877,3498,2725,773,758,219,392,4,142,1,0,15,2312,1718,594,584,198,272,3,111,0,0,10,877,849,28,10576110.109181,13500.303248
852,48,201,533801,8645,2357,8645,5528,3117,3088,405,1775,11,881,7,9,29,5540,3309,2231,2216,336,1174,9,687,5,5,15,2357,2226,131,91492009.895323,42123.118184
853,48,201,533802,6182,1749,6182,4229,1953,1919,557,835,5,485,25,12,34,3972,2498,1474,1456,465,597,5,368,10,11,18,1749,1624,125,59472927.375418,32525.99808
854,48,201,533901,9260,2605,9260,4949,4311,4216,716,2791,9,685,0,15,95,6206,3035,3171,3131,625,1963,6,529,0,8,40,2605,2480,125,31061821.850725,26776.123812
855,48,201,533902,4408,1653,4408,2322,2086,2061,202,1642,9,201,0,7,25,2851,1445,1406,1386,163,1045,8,167,0,3,20,1653,1451,202,20735675.102691,21776.416952
856,48,201,534001,2959,1018,2959,2064,895,885,388,238,4,255,0,0,10,1948,1250,698,694,332,172,4,186,0,0,4,1018,905,113,40765328.560699,29525.877335
857,48,201,534002,5680,1501,5680,3686,1994,1954,617,1102,7,221,0,7,40,3711,2259,1452,1435,512,737,4,177,0,5,17,1501,1431,70,35137383.721182,27213.862355
858,48,201,534003,2678,741,2678,1569,1109,1081,106,673,1,294,0,7,28,1704,961,743,734,83,433,1,213,0,4,9,741,713,28,14021966.639392,17672.812668
859,48,201,534100,7488,2153,7488,3889,3599,3517,1273,908,16,1308,1,11,82,5149,2443,2706,2665,1051,630,9,968,0,7,41,2153,2041,112,137144117.797287,50752.316854
860,48,201,534201,2582,890,2582,1610,972,951,468,185,1,287,1,9,21,1786,975,811,797,419,149,1,222,1,5,14,890,805,85,37449708.450077,28731.02196
861,48,201,534202,8515,3769,8515,2006,6509,6401,4565,896,14,904,0,22,108,6484,1300,5184,5127,3764,636,11,702,0,14,57,3769,3382,387,49885044.997556,31778.176616
862,48,201,534203,1716,539,1716,1020,696,691,418,139,6,127,0,1,5,1179,603,576,572,369,105,3,94,0,1,4,539,509,30,45519046.606614,31413.204384
863,48,201,540100,12349,4080,12349,3625,8724,8531,5205,631,18,2643,1,33,193,8672,2309,6363,6259,3896,443,14,1884,1,21,104,4080,3946,134,242062930.365108,63925.982317
864,48,201,540200,2654,1006,2654,1597,1057,1039,596,170,5,260,5,3,18,1960,1085,875,862,510,129,5,213,5,0,13,1006,938,68,26977464.453387,21634.18618
865,48,201,540501,6024,2617,6024,3690,2334,2253,1282,753,4,196,2,16,81,4097,2296,1801,1759,1071,522,4,154,2,6,42,2617,2291,326,18630797.089953,29096.923293
866,48,201,540502,5248,1914,5248,1555,3693,3613,3211,235,12,141,1,13,80,3934,993,2941,2901,2605,169,9,110,1,7,40,1914,1847,67,38202841.757362,29002.014437
867,48,201,540601,2632,898,2632,715,1917,1856,1103,328,5,408,1,11,61,1919,457,1462,1426,875,242,3,301,1,4,36,898,859,39,21697245.896898,25093.355573
868,48,201,540602,6979,2461,6979,2957,4022,3894,2032,1153,27,664,3,15,128,4792,1889,2903,2848,1561,758,20,504,2,3,55,2461,2316,145,29717877.725165,24617.896109
869,48,201,540700,7505,2313,7505,3155,4350,4239,2556,518,10,1129,8,18,111,5241,1921,3320,3256,1981,371,8,883,3,10,64,2313,2255,58,84431183.193809,49873.285093
870,48,201,540800,7883,2629,7883,4475,3408,3312,1765,837,6,688,1,15,96,5458,2845,2613,2559,1428,601,6,514,1,9,54,2629,2520,109,103092700.214413,48621.387994
871,48,201,540901,2496,1062,2496,329,2167,2129,1736,236,13,142,0,2,38,1967,228,1739,1717,1417,168,10,120,0,2,22,1062,1019,43,17289206.72416,19781.707047
872,48,201,540902,6965,3221,6965,1676,5289,5170,3449,1045,16,647,1,12,119,5336,1125,4211,4155,2842,777,15,514,1,6,56,3221,2933,288,48964475.800777,38662.895188
873,48,201,541001,10368,4106,10368,2491,7877,7668,3953,2164,27,1503,3,18,209,7464,1628,5836,5719,3026,1551,23,1104,3,12,117,4106,3892,214,57619241.134547,35677.398794
874,48,201,541002,7924,2524,7924,1605,6319,6167,3762,1188,14,1166,6,31,152,5257,1006,4251,4185,2597,760,10,799,4,15,66,2524,2447,77,78991354.139497,47145.774909
875,48,201,541003,12938,4209,12938,2803,10135,9886,5909,2080,27,1828,7,35,249,8574,1703,6871,6754,4088,1357,17,1272,5,15,117,4209,4069,140,78454457.452417,37548.851078
876,48,201,541100,6536,2317,6536,1226,5310,5191,4157,542,26,447,4,15,119,4768,783,3985,3922,3154,388,18,351,4,7,63,2317,2249,68,36608066.424953,29080.587347
877,48,201,541201,8799,2979,8799,1541,7258,7110,5381,829,17,865,1,17,148,6073,957,5116,5044,3835,574,15,609,1,10,72,2979,2880,99,48446692.02889,30472.51605
878,48,201,541202,8811,2957,8811,3098,5713,5596,4364,784,13,425,1,9,117,6155,1955,4200,4131,3224,548,13,339,1,6,69,2957,2842,115,34453270.120735,25072.905772
879,48,201,541203,2682,1025,2682,281,2401,2354,2118,110,5,118,0,3,47,2074,195,1879,1856,1657,84,5,107,0,3,23,1025,1001,24,16479886.530127,18466.13692
880,48,201,541300,11303,3547,11303,5958,5345,5213,2557,1791,34,757,11,63,132,7512,3686,3826,3756,1984,1135,24,573,10,30,70,3547,3384,163,57379597.162792,33899.070306
881,48,201,541400,14539,4912,14539,5992,8547,8343,3333,2641,36,2279,21,33,204,9958,3689,6269,6161,2669,1770,26,1667,14,15,108,4912,4549,363,47649754.596882,27653.954899
882,48,201,541500,5216,1640,5216,1884,3332,3257,1924,657,13,643,4,16,75,3535,1133,2402,2378,1459,443,8,453,3,12,24,1640,1587,53,33107888.616304,25435.639852
883,48,201,541601,4430,1651,4430,848,3582,3509,2845,371,10,273,1,9,73,3395,528,2867,2829,2347,264,7,206,1,4,38,1651,1592,59,50156370.6009,29947.591294
884,48,201,541602,9669,3052,9669,5864,3805,3702,2332,645,5,700,0,20,103,6647,3677,2970,2919,1922,451,4,531,0,11,51,3052,2855,197,54530453.516524,30345.291582
885,48,201,541700,9712,4243,9712,3834,5878,5680,2856,1837,19,929,8,31,198,7039,2515,4524,4410,2370,1278,17,718,7,20,114,4243,3840,403,230904250.82471,62503.836873
886,48,201,541800,5762,2436,5762,2243,3519,3407,2236,791,25,338,2,15,112,4182,1459,2723,2653,1818,555,19,248,2,11,70,2436,2181,255,54955379.204311,30877.521897
887,48,201,541900,6402,2163,6402,2146,4256,4161,2912,679,20,531,3,16,95,4601,1382,3219,3166,2283,456,17,398,1,11,53,2163,2082,81,59875426.313422,33537.749341
888,48,201,542000,15167,4526,15167,6432,8735,8479,5030,2149,47,1188,16,49,256,10217,4057,6160,6054,3771,1370,31,848,11,23,106,4526,4412,114,58096822.042215,32493.474799
889,48,201,542101,17754,5218,17754,9616,8138,7857,3541,3522,15,720,17,42,281,11283,5797,5486,5367,2621,2154,12,544,12,24,119,5218,4899,319,97921639.16756,47157.917489
890,48,201,542102,14625,4287,14625,6532,8093,7840,3438,3439,27,889,5,42,253,9418,3925,5493,5376,2559,2140,18,635,4,20,117,4287,4078,209,68391190.488581,37131.995977
891,48,201,542200,16532,4990,16532,7793,8739,8386,4315,3352,18,639,16,46,353,10659,4695,5964,5800,3206,2072,14,474,10,24,164,4990,4742,248,258338970.902264,72104.686935
892,48,201,542301,12365,3735,12365,5468,6897,6700,4024,1826,26,776,3,45,197,8103,3333,4770,4682,2928,1148,19,556,3,28,88,3735,3609,126,64270749.889059,36506.714296
893,48,201,542302,6459,2077,6459,2748,3711,3588,1923,1230,12,406,1,16,123,4186,1691,2495,2444,1378,761,9,286,0,10,51,2077,1996,81,49052595.608985,40202.320045
894,48,201,542400,10040,3335,10040,5260,4780,4626,2711,1443,24,426,1,21,154,6816,3297,3519,3441,2154,938,21,312,1,15,78,3335,3178,157,62320668.521894,32963.73145
895,48,201,542500,2161,1036,2161,236,1925,1895,1807,58,2,22,2,4,30,1741,175,1566,1552,1486,42,1,17,2,4,14,1036,833,203,47131287.241575,27685.55145
896,48,201,542600,4393,1443,4393,1669,2724,2663,1925,501,9,217,2,9,61,2987,1063,1924,1902,1387,334,9,166,2,4,22,1443,1375,68,49476351.23916,28684.851477
897,48,201,542700,4393,1578,4393,1304,3089,3053,2784,190,12,57,0,10,36,3314,856,2458,2437,2245,135,7,43,0,7,21,1578,1512,66,51682741.453422,29333.498512
898,48,201,542800,6983,2314,6983,2235,4748,4639,4216,307,16,92,0,8,109,4844,1353,3491,3451,3186,186,13,58,0,8,40,2314,2226,88,96951538.493686,41361.871007
899,48,201,542900,11156,3586,11156,4167,6989,6815,5286,1102,18,375,8,26,174,7494,2572,4922,4842,3819,722,14,268,3,16,80,3586,3415,171,591852748.033894,122416.683268
900,48,201,543001,6421,1999,6421,1932,4489,4361,2433,1315,13,574,4,22,128,4051,1136,2915,2856,1633,831,8,368,4,12,59,1999,1844,155,1204012461.92081,154806.776134
901,48,201,543002,10057,3744,10057,1943,8114,7950,5409,1286,8,1223,4,20,164,6838,1218,5620,5541,3826,861,7,833,2,12,79,3744,3271,473,368557765.107863,86317.205824
902,48,201,543003,16578,4897,16578,7947,8631,8363,3857,3560,30,873,9,34,268,10415,4662,5753,5645,2826,2166,22,606,7,18,108,4897,4668,229,66351951.53784,35986.077741
903,48,201,543100,2155,656,2155,1133,1022,1008,807,158,1,23,3,16,14,1389,627,762,756,628,103,1,18,1,5,6,656,585,71,1397454259.10593,174384.306288
904,48,201,543200,5924,2776,5924,2201,3723,3655,2478,479,5,685,2,6,68,4485,1460,3025,2986,2101,306,5,569,2,3,39,2776,2323,453,436830809.815942,88084.34797
905,48,201,550100,4719,2179,4719,2479,2240,2177,121,1998,4,45,2,7,63,2953,1499,1454,1413,100,1270,4,34,2,3,41,2179,1658,521,37887085.319605,31150.645574
906,48,201,550200,3727,1825,3727,1264,2463,2380,149,2193,4,28,1,5,83,2436,793,1643,1591,122,1440,3,22,1,3,52,1825,1469,356,26922987.225306,23218.998573
907,48,201,550301,6600,3584,6600,1589,5011,4890,443,4315,17,89,8,18,121,4490,1066,3424,3354,402,2857,14,69,5,7,70,3584,2831,753,30390691.30563,30448.912752
908,48,201,550302,8785,4271,8785,2945,5840,5701,1509,3840,14,310,7,21,139,6320,1952,4368,4287,1343,2651,12,262,3,16,81,4271,3517,754,95903749.943305,43580.193411
909,48,201,550401,10249,4691,10249,4140,6109,5979,832,4318,14,800,3,12,130,6885,2589,4296,4226,705,2944,13,557,2,5,70,4691,3531,1160,108286942.96322,45759.566237
910,48,201,550402,9449,3837,9449,2071,7378,7284,470,6082,8,702,2,20,94,6517,1312,5205,5152,390,4243,4,502,2,11,53,3837,3166,671,50747552.159936,44834.698085
911,48,201,550500,5665,1819,5665,2689,2976,2892,313,1934,2,631,2,10,84,3777,1714,2063,2017,241,1318,2,451,2,3,46,1819,1720,99,47120648.110093,30912.524955
912,48,201,550601,6731,1846,6731,3168,3563,3473,284,2700,1,467,14,7,90,4459,1975,2484,2441,246,1815,1,366,7,6,43,1846,1774,72,21905509.591155,18349.917016
913,48,201,550602,3015,825,3015,1521,1494,1467,82,1117,7,254,0,7,27,2012,932,1080,1064,72,781,7,199,0,5,16,825,791,34,12082583.615983,14740.494679
914,48,201,550603,5632,1738,5632,3186,2446,2427,182,1816,4,421,0,4,19,3732,1971,1761,1748,157,1260,3,328,0,0,13,1738,1596,142,18765485.477217,20478.76157
915,48,201,550700,3038,873,3038,1341,1697,1668,242,938,3,475,5,5,29,2059,829,1230,1213,194,658,3,352,1,5,17,873,839,34,65793175.932021,50763.398462
916,48,201,550800,3468,994,3468,1185,2283,2254,118,1924,5,198,0,9,29,2229,725,1504,1485,101,1215,2,162,0,5,19,994,934,60,21534259.25894,22187.397384
917,48,201,550900,8741,2618,8741,4435,4306,4209,738,1942,14,1494,2,19,97,5937,2788,3149,3103,615,1361,9,1107,2,9,46,2618,2468,150,34282908.259225,24704.03363
918,48,201,551000,3377,884,3377,2183,1194,1174,212,616,2,336,3,5,20,2154,1329,825,813,158,398,1,251,2,3,12,884,832,52,11957311.550816,16540.874122
919,48,201,551100,9497,3500,9497,3800,5697,5590,955,3187,12,1405,7,24,107,6566,2413,4153,4096,842,2150,5,1081,5,13,57,3500,3117,383,49809914.972271,30850.214471
920,48,201,551200,6747,2690,6747,2174,4573,4470,2556,1122,22,755,1,14,103,5172,1496,3676,3626,2195,838,15,567,1,10,50,2690,2507,183,38454799.225843,27745.197358
921,48,201,551300,3818,1174,3818,1143,2675,2630,1099,690,24,806,3,8,45,2788,739,2049,2029,939,500,19,561,3,7,20,1174,1138,36,21385382.160419,19400.688994
922,48,201,551400,4335,1997,4335,1253,3082,3023,1697,832,14,470,5,5,59,3396,856,2540,2502,1462,649,10,371,5,5,38,1997,1762,235,86007308.52943,38499.627566
923,48,201,551500,7803,2847,7803,3116,4687,4572,1466,1690,16,1382,0,18,115,5484,2078,3406,3357,1235,1087,12,1015,0,8,49,2847,2622,225,107386143.925288,52563.008473
924,48,201,551600,8294,2775,8294,3822,4472,4357,2295,1345,29,663,3,22,115,5904,2411,3493,3428,1924,955,23,514,3,9,65,2775,2580,195,33022076.845063,29775.320752
925,48,201,551701,9087,3539,9087,2100,6987,6802,4525,968,23,1269,1,16,185,6751,1363,5388,5294,3563,708,18,993,1,11,94,3539,3365,174,48569377.466828,34376.843908
926,48,201,551702,4024,1297,4024,571,3453,3369,2077,225,5,1055,3,4,84,2841,375,2466,2443,1514,159,4,763,1,2,23,1297,1279,18,22383017.525429,20860.943222
927,48,201,551703,7692,3114,7692,1983,5709,5578,3387,942,13,1205,4,27,131,5678,1334,4344,4282,2673,681,11,896,4,17,62,3114,2948,166,33557782.469335,26858.578326
928,48,201,551800,4386,1753,4386,461,3925,3877,3570,71,13,220,0,3,48,3608,326,3282,3254,3001,53,9,188,0,3,28,1753,1706,47,65979644.923934,34628.127821
929,48,201,551900,5881,3144,5881,1850,4031,3916,1809,1697,11,383,2,14,115,4414,1256,3158,3095,1568,1204,10,305,2,6,63,3144,2824,320,19220966.726156,19353.084871
930,48,201,552001,8117,3691,8117,1986,6131,5956,3779,1106,22,1017,12,20,175,6126,1336,4790,4705,3121,784,19,757,10,14,85,3691,3392,299,47577621.096561,30481.043343
931,48,201,552002,1415,593,1415,291,1124,1101,764,168,4,165,0,0,23,1065,194,871,857,604,129,4,120,0,0,14,593,567,26,17968459.452186,19306.356521
932,48,201,552101,3883,1557,3883,1009,2874,2796,1491,772,10,514,2,7,78,2795,668,2127,2090,1150,564,3,367,2,4,37,1557,1416,141,25531515.536888,20927.625739
933,48,201,552102,5928,2152,5928,1136,4792,4691,3537,345,21,771,7,10,101,4364,736,3628,3576,2732,254,16,563,6,5,52,2152,2078,74,34094086.243664,27305.640979
934,48,201,552103,2954,1026,2954,844,2110,2066,1556,339,14,157,0,0,44,2105,519,1586,1563,1214,221,11,117,0,0,23,1026,959,67,16793617.637781,18575.074115
935,48,201,552200,6511,2483,6511,1896,4615,4491,3195,888,23,361,2,22,124,4617,1157,3460,3403,2563,540,20,265,1,14,57,2483,2334,149,107969320.596805,57591.790853
936,48,201,552301,3961,1613,3961,458,3503,3457,3111,211,16,116,0,3,46,3028,273,2755,2729,2485,141,12,90,0,1,26,1613,1518,95,46409273.297771,31732.893444
937,48,201,552302,4962,2252,4962,950,4012,3899,2809,665,13,387,4,21,113,3801,657,3144,3093,2329,458,7,282,2,15,51,2252,2164,88,39175019.508167,26636.600214
938,48,201,552400,6599,2589,6599,1974,4625,4510,2865,913,14,703,5,10,115,4800,1238,3562,3515,2335,616,9,540,5,10,47,2589,2432,157,65795810.425967,32577.587163
939,48,201,552500,10270,3868,10270,3439,6831,6661,4378,1204,33,1026,11,9,170,7324,2204,5120,5033,3431,823,26,739,10,4,87,3868,3585,283,58889103.78109,33481.769392
940,48,201,552601,5339,2227,5339,1736,3603,3486,1487,1451,14,524,7,3,117,3704,1137,2567,2502,1192,916,9,376,6,3,65,2227,2055,172,30914219.773386,28049.667016
941,48,201,552602,5968,2903,5968,898,5070,4976,3807,530,27,593,4,15,94,4765,647,4118,4057,3176,407,22,439,4,9,61,2903,2587,316,56963947.406445,39717.071949
942,48,201,552700,8092,4476,8092,1489,6603,6465,4562,928,35,923,0,17,138,6450,1008,5442,5367,3913,693,29,721,0,11,75,4476,3947,529,53746992.146163,34751.566116
943,48,201,552800,8826,4415,8826,989,7837,7720,6401,809,25,470,2,13,117,7245,708,6537,6467,5455,604,19,377,2,10,70,4415,4110,305,70055143.776282,40392.419479
944,48,201,552900,6966,3753,6966,1002,5964,5852,4472,934,17,419,1,9,112,5706,712,4994,4929,3887,698,15,322,1,6,65,3753,3311,442,52562010.410468,30957.912043
945,48,201,553001,5044,2161,5044,1003,4041,3959,2381,1170,9,387,2,10,82,3985,697,3288,3239,2053,841,9,328,2,6,49,2161,1857,304,50927524.747617,31223.212985
946,48,201,553002,4565,1730,4565,1425,3140,3051,1706,923,7,404,7,4,89,3446,934,2512,2463,1503,612,7,330,7,4,49,1730,1582,148,49902687.449432,33210.614837
947,48,201,553100,6140,2675,6140,1572,4568,4440,2628,1488,22,269,9,24,128,4622,1046,3576,3516,2254,998,19,222,7,16,60,2675,2372,303,36640357.937037,26678.959815
948,48,201,553200,6743,3120,6743,1994,4749,4620,2177,2230,4,171,13,25,129,5000,1346,3654,3588,1912,1500,3,153,8,12,66,3120,2598,522,46148962.086131,36912.847064
949,48,201,553300,4600,2744,4600,933,3667,3577,976,2444,12,111,23,11,90,3463,666,2797,2748,875,1747,10,98,12,6,49,2744,2213,531,15042208.131164,15461.415896
950,48,201,553401,3815,1421,3815,540,3275,3222,2804,206,4,199,0,9,53,2924,367,2557,2533,2217,160,3,149,0,4,24,1421,1351,70,40567010.372966,35301.778179
951,48,201,553402,6899,2546,6899,1182,5717,5626,4554,580,24,457,9,2,91,5230,824,4406,4352,3548,429,20,346,7,2,54,2546,2458,88,57989118.059837,33674.886274
952,48,201,553403,6185,2091,6185,1350,4835,4720,3257,524,4,908,6,21,115,4321,841,3480,3424,2419,355,4,628,6,12,56,2091,2025,66,71716779.684772,55195.522118
953,48,201,553500,6370,2339,6370,1385,4985,4878,4211,359,22,277,1,8,107,4750,875,3875,3807,3301,267,18,215,1,5,68,2339,2247,92,38440865.715769,25455.58231
954,48,201,553600,6273,2632,6273,1020,5253,5134,4050,463,17,593,3,8,119,4713,671,4042,3973,3203,325,12,428,1,4,69,2632,2391,241,52293667.12269,35467.003732
955,48,201,553700,3960,1598,3960,578,3382,3319,2516,382,7,408,1,5,63,3013,387,2626,2592,2015,279,4,289,1,4,34,1598,1482,116,34030783.058447,29415.342233
956,48,201,553801,2486,820,2486,313,2173,2128,1928,104,10,83,0,3,45,1808,218,1590,1572,1426,79,4,61,0,2,18,820,793,27,39854608.166102,33898.840567
957,48,201,553802,7672,3004,7672,1438,6234,6082,4870,621,23,538,7,23,152,5637,954,4683,4597,3791,395,11,382,6,12,86,3004,2772,232,58598731.011031,30893.850365
958,48,201,553900,7748,2662,7748,846,6902,6756,5307,688,33,681,4,43,146,5694,545,5149,5078,4035,493,19,500,3,28,71,2662,2549,113,56146772.565755,32527.846726
959,48,201,554001,3299,1557,3299,612,2687,2625,2072,306,10,232,0,5,62,2461,409,2052,2023,1647,194,7,172,0,3,29,1557,1336,221,36141510.653066,26510.762767
960,48,201,554002,4307,1559,4307,427,3880,3819,3352,136,8,320,1,2,61,3279,301,2978,2945,2589,103,7,243,1,2,33,1559,1513,46,46694047.560318,28714.051205
961,48,201,554101,1245,420,1245,149,1096,1081,939,89,0,53,0,0,15,932,85,847,838,731,64,0,43,0,0,9,420,406,14,8471499.579359,20693.49828
962,48,201,554102,9399,3305,9399,1545,7854,7667,5942,580,25,1105,7,8,187,6805,999,5806,5740,4512,416,21,785,5,1,66,3305,3197,108,48625112.298076,29562.069728
963,48,201,554200,6229,2738,6229,1780,4449,4345,3261,626,28,413,6,11,104,4568,1125,3443,3386,2566,458,21,331,5,5,57,2738,2348,390,77058340.369182,40401.420222
964,48,201,554301,7331,2705,7331,704,6627,6541,6020,157,38,307,0,19,86,5660,477,5183,5144,4775,118,27,216,0,8,39,2705,2635,70,59779973.715422,37859.491712
965,48,201,554302,4420,1644,4420,780,3640,3516,2650,431,8,413,11,3,124,3187,502,2685,2632,2040,292,7,284,7,2,53,1644,1571,73,63775374.594849,41836.302318
966,48,201,554401,13497,4552,13497,1406,12091,11893,10410,420,46,976,6,35,198,8859,824,8035,7959,7013,290,33,600,4,19,76,4552,4408,144,162649839.598241,66592.147387
967,48,201,554402,12826,4185,12826,2306,10520,10347,8440,1000,48,815,10,34,173,8554,1415,7139,7069,5776,675,28,568,5,17,70,4185,4031,154,153785782.177585,57820.788835
968,48,201,554403,8692,2921,8692,2291,6401,6283,4899,956,30,384,4,10,118,5765,1350,4415,4364,3413,639,20,284,2,6,51,2921,2810,111,116097986.430622,50103.459926
969,48,201,554501,5287,1739,5287,1068,4219,4158,3586,359,15,191,0,7,61,3497,632,2865,2837,2465,231,12,127,0,2,28,1739,1666,73,133364705.948035,56854.806512
970,48,201,554502,6327,2163,6327,668,5659,5572,5063,215,27,251,1,15,87,4384,395,3989,3954,3603,146,17,175,1,12,35,2163,2106,57,49978424.150928,35172.520134
971,48,201,554600,4605,1620,4605,390,4215,4160,3891,124,12,127,0,6,55,3395,255,3140,3108,2910,93,11,90,0,4,32,1620,1559,61,39327011.069644,28815.215856
972,48,201,554700,6937,2663,6937,921,6016,5900,4773,331,14,770,3,9,116,5019,633,4386,4323,3499,258,11,545,3,7,63,2663,2556,107,49585166.17613,32270.549667
973,48,201,554801,14076,4629,14076,3997,10079,9803,7113,1574,41,1036,7,32,276,9245,2402,6843,6732,4958,1002,25,722,5,20,111,4629,4434,195,153917382.943594,56823.391509
974,48,201,554802,15009,5108,15009,2779,12230,11962,9937,859,34,1108,3,21,268,9961,1621,8340,8245,6935,567,29,700,2,12,95,5108,4839,269,366272412.69111,97268.076366
975,48,201,554901,8373,2660,8373,2330,6043,5854,4301,917,32,549,16,39,189,5544,1400,4144,4079,3021,605,23,394,10,26,65,2660,2522,138,94511412.750407,45204.0882
976,48,201,554902,6182,2080,6182,971,5211,5106,4632,308,15,139,2,10,105,4406,575,3831,3777,3454,202,14,100,2,5,54,2080,2016,64,137497628.236491,61632.786771
977,48,201,554903,11314,3744,11314,1958,9356,9149,7045,947,19,1098,17,23,207,7577,1150,6427,6346,4930,631,15,754,6,10,81,3744,3646,98,148586517.030894,54760.607885
978,48,201,555000,7449,2446,7449,1844,5605,5476,4420,587,36,409,10,14,129,5203,1158,4045,3986,3264,396,27,285,8,6,59,2446,2372,74,59879984.943855,42994.89616
979,48,201,555100,8149,2856,8149,1918,6231,6116,4658,850,24,560,11,13,115,5729,1196,4533,4485,3489,562,16,404,9,5,48,2856,2757,99,81597860.6097,46052.507587
980,48,201,555200,6413,2300,6413,2069,4344,4255,3759,369,17,90,2,18,89,4511,1239,3272,3232,2895,244,17,66,2,8,40,2300,2162,138,202113551.237018,75041.642579
981,48,201,555301,960,361,960,81,879,868,791,34,1,42,0,0,11,720,53,667,661,606,22,1,32,0,0,6,361,345,16,70314021.143675,78938.25101
982,48,201,555302,9219,3326,9219,1741,7478,7345,6546,389,29,366,0,15,133,6324,1026,5298,5241,4687,263,22,260,0,9,57,3326,2997,329,208944037.779895,71218.845359
983,48,201,555303,4090,1625,4090,866,3224,3158,2702,356,7,90,0,3,66,2889,517,2372,2342,2012,255,6,69,0,0,30,1625,1409,216,229247293.380144,97482.160856
984,48,201,555401,2445,973,2445,448,1997,1967,1683,255,14,4,7,4,30,1882,294,1588,1577,1363,192,14,4,4,0,11,973,894,79,145717252.505429,63035.016681
985,48,201,555402,7774,3605,7774,1293,6481,6365,5832,379,36,96,4,18,116,6017,843,5174,5113,4733,257,30,75,4,14,61,3605,3238,367,154076877.561674,61202.374932
986,48,201,555501,4324,1660,4324,967,3357,3310,3213,67,5,22,0,3,47,3240,614,2626,2602,2526,53,4,19,0,0,24,1660,1549,111,446672966.992678,98904.92515
987,48,201,555502,17016,5885,17016,3548,13468,13228,10828,1071,39,1257,4,29,240,11631,2174,9457,9349,7759,705,26,843,3,13,108,5885,5666,219,379932859.156925,94995.941284
988,48,201,555600,4717,1669,4717,884,3833,3790,3649,59,8,68,0,6,43,3485,538,2947,2929,2825,43,6,50,0,5,18,1669,1581,88,590995553.174568,122107.059974
989,48,201,555701,7064,2203,7064,1245,5819,5727,4897,510,21,293,6,0,92,4532,717,3815,3778,3229,329,11,207,2,0,37,2203,2167,36,115411914.769726,81900.197855
990,48,201,555702,9389,2942,9389,1169,8220,8094,7081,533,33,428,4,15,126,5896,682,5214,5172,4495,352,24,294,2,5,42,2942,2848,94,125869533.499619,50071.346907
991,48,201,556000,6462,2236,6462,2509,3953,3876,2978,799,35,43,5,16,77,4404,1491,2913,2884,2272,536,28,38,3,7,29,2236,1997,239,1451492577.241,234300.367965
992,48,201,980000,33,17,33,9,24,23,11,12,0,0,0,0,1,24,4,20,19,11,8,0,0,0,0,1,17,15,2,60614546.405176,33936.791474
993,48,201,980100,603,254,603,157,446,439,53,373,2,7,4,0,7,351,89,262,258,40,207,2,6,3,0,4,254,224,30,341675443.954041,98654.332184
994,48,291,700100,4147,1489,4147,1496,2651,2590,2466,85,19,16,1,3,61,2886,878,2008,1980,1889,60,15,12,1,3,28,1489,1330,159,556847869.819714,115918.425094
995,48,291,700200,3042,1157,3042,500,2542,2504,1030,1388,3,80,0,3,38,2372,371,2001,1982,851,1068,3,58,0,2,19,1157,1024,133,175364742.164,86250.470309
996,48,291,700300,9514,3663,9514,2458,7056,6959,6390,478,40,37,1,13,97,6752,1439,5313,5269,4892,301,35,32,1,8,44,3663,3242,421,2158218743.92969,243829.382028
997,48,291,700400,6334,2548,6334,281,6053,6006,5953,31,11,8,0,3,47,4572,167,4405,4376,4336,25,7,7,0,1,29,2548,2253,295,3943648732.93876,432690.731819
998,48,291,700500,2423,1072,2423,109,2314,2284,2192,77,13,1,0,1,30,1774,69,1705,1682,1614,57,10,1,0,0,23,1072,857,215,3095577324.06316,332658.652731
999,48,291,700600,2862,1700,2862,232,2630,2599,2499,79,17,3,1,0,31,2227,134,2093,2075,1991,65,15,3,1,0,18,1700,1164,536,3454876927.05964,317392.669152
1000,48,291,700700,2507,1034,2507,184,2323,2303,2147,144,10,1,0,1,20,1844,117,1727,1714,1606,100,7,1,0,0,13,1034,916,118,1478300507.92731,221949.385842
1001,48,291,700800,8892,3520,8892,962,7930,7834,7047,664,49,65,4,5,96,6547,569,5978,5932,5373,462,40,52,3,2,46,3520,3207,313,1128817437.82978,203762.867783
1002,48,291,700900,6059,862,6059,1483,4576,4531,2948,1534,13,19,0,17,45,5528,1359,4169,4140,2624,1470,13,16,0,17,29,862,751,111,1825514609.74749,209545.913121
1003,48,291,701000,6216,2147,6216,2527,3689,3622,3044,518,26,30,2,2,67,4193,1462,2731,2700,2302,346,25,23,2,2,31,2147,1897,250,1976670836.43558,213924.606655
1004,48,291,701100,6954,2728,6954,768,6186,6072,5595,400,43,19,10,5,114,5140,452,4688,4627,4271,297,32,14,10,3,61,2728,2422,306,2053463783.45266,307815.816432
1005,48,291,701200,6089,2572,6089,905,5184,5116,4339,723,10,36,1,7,68,4561,566,3995,3961,3392,524,10,31,1,3,34,2572,2288,284,1704839325.23242,338440.646588
1006,48,291,701300,3492,1537,3492,274,3218,3163,2963,167,18,6,1,8,55,2626,164,2462,2426,2264,135,16,5,1,5,36,1537,1319,218,3847099991.61926,346804.309071
1007,48,291,701400,7112,2730,7112,1423,5689,5581,3708,1786,17,16,2,52,108,5254,861,4393,4342,2860,1413,13,14,1,41,51,2730,2403,327,5393206182.53306,364763.461172
1008,48,339,690100,9909,3499,9909,2293,7616,7497,7285,102,55,38,1,16,119,7128,1449,5679,5605,5460,70,38,28,1,8,74,3499,3317,182,622036437.637139,149700.737075
1009,48,339,690201,9537,3375,9537,1042,8495,8393,8094,165,54,57,2,21,102,6685,586,6099,6046,5844,113,30,47,1,11,53,3375,3179,196,612848696.21525,123539.470376
1010,48,339,690202,6770,2443,6770,1205,5565,5513,5373,79,24,26,2,9,52,5014,705,4309,4283,4174,59,22,18,2,8,26,2443,2304,139,431057434.009455,116186.511958
1011,48,339,690300,4681,1742,4681,1100,3581,3536,3262,241,20,12,0,1,45,3436,654,2782,2758,2541,189,20,7,0,1,24,1742,1596,146,437980752.488266,122272.011895
1012,48,339,690401,5643,1825,5643,551,5092,5003,4651,188,34,108,8,14,89,3804,345,3459,3427,3178,134,27,76,6,6,32,1825,1761,64,441644349.431139,140711.275597
1013,48,339,690402,15781,5264,15781,3501,12280,12128,11717,219,70,94,3,25,152,10897,2002,8895,8810,8503,159,51,76,3,18,85,5264,4988,276,897761840.446077,145557.147833
1014,48,339,690500,7570,2688,7570,746,6824,6734,6483,109,42,90,2,8,90,5665,493,5172,5122,4935,79,32,67,2,7,50,2688,2609,79,414410098.223122,110263.487961
1015,48,339,690601,20181,7788,20181,2168,18013,17661,16292,295,61,974,15,24,352,13985,1336,12649,12508,11579,206,42,665,10,6,141,7788,7339,449,236672363.301713,83576.431966
1016,48,339,690602,18616,6339,18616,2934,15682,15440,13643,488,32,1225,13,39,242,11560,1676,9884,9791,8673,308,23,761,8,18,93,6339,5855,484,321768653.112566,90634.944919
1017,48,339,690700,8127,4562,8127,815,7312,7206,6478,331,32,351,3,11,106,7063,613,6450,6380,5770,279,31,288,3,9,70,4562,4217,345,164024517.449397,57999.245308
1018,48,339,690800,4237,1619,4237,387,3850,3788,3523,65,13,179,1,7,62,3133,259,2874,2851,2661,49,8,125,1,7,23,1619,1556,63,53178176.367245,39527.202007
1019,48,339,690900,4459,1433,4459,409,4050,3987,3730,59,7,176,0,15,63,3013,245,2768,2742,2568,44,6,116,0,8,26,1433,1406,27,52097948.416159,37622.642473
1020,48,339,691000,3993,1518,3993,235,3758,3733,3579,47,7,94,1,5,25,3092,155,2937,2927,2825,28,7,61,1,5,10,1518,1487,31,49962253.529496,42324.666392
1021,48,339,691100,4170,1600,4170,570,3600,3545,3347,58,20,112,1,7,55,3035,370,2665,2637,2498,45,14,75,1,4,28,1600,1543,57,25181409.22452,28548.795347
1022,48,339,691200,7228,3029,7228,648,6580,6467,5953,162,15,325,0,12,113,5646,412,5234,5187,4779,125,12,262,0,9,47,3029,2909,120,68949321.314807,35573.480226
1023,48,339,691301,4485,1626,4485,425,4060,3986,3707,67,20,188,0,4,74,3223,291,2932,2900,2700,59,12,126,0,3,32,1626,1576,50,60989494.411338,44242.414297
1024,48,339,691302,5581,2636,5581,764,4817,4701,4265,275,25,110,4,22,116,4295,518,3777,3719,3416,181,22,86,4,10,58,2636,2531,105,45350515.374077,45309.124378
1025,48,339,691400,8644,4143,8644,1298,7346,7203,6324,454,23,382,6,14,143,6710,913,5797,5723,5072,318,20,295,5,13,74,4143,3702,441,160435947.885531,76080.885588
1026,48,339,691500,3954,1888,3954,690,3264,3189,2750,203,15,209,8,4,75,3065,459,2606,2560,2253,129,12,159,4,3,46,1888,1718,170,47904012.562531,37060.502844
1027,48,339,691601,3836,2007,3836,387,3449,3389,3132,91,7,140,5,14,60,3176,276,2900,2856,2664,70,7,108,3,4,44,2007,1875,132,38925398.970459,27739.127049
1028,48,339,691602,5200,2236,5200,1390,3810,3736,3260,292,17,148,13,6,74,3994,946,3048,3012,2672,195,17,115,7,6,36,2236,2109,127,30860074.974789,23888.228572
1029,48,339,691700,1127,828,1127,130,997,982,904,18,1,56,1,2,15,996,95,901,895,828,16,1,48,1,1,6,828,643,185,63640968.005945,35675.139152
1030,48,339,691800,7799,3266,7799,1974,5825,5720,5139,341,22,200,9,9,105,5987,1364,4623,4572,4156,236,20,145,8,7,51,3266,2938,328,76428942.173438,45717.286162
1031,48,339,691900,6239,2222,6239,1294,4945,4863,4390,312,34,123,0,4,82,4369,799,3570,3524,3232,183,25,81,0,3,46,2222,2142,80,89837005.862119,59221.391567
1032,48,339,692001,25252,8478,25252,4887,20365,19865,17044,1940,96,686,48,51,500,17023,3007,14016,13806,11883,1277,70,505,38,33,210,8478,8155,323,457631224.054678,121394.767069
1033,48,339,692002,5961,2090,5961,885,5076,4985,4299,421,18,230,1,16,91,4110,542,3568,3520,3052,283,14,160,1,10,48,2090,1987,103,723174224.02782,150302.260949
1034,48,339,692100,10690,3701,10690,2376,8314,8173,7062,608,50,434,2,17,141,7310,1465,5845,5783,5007,420,39,310,2,5,62,3701,3477,224,419569291.293723,99682.19605
1035,48,339,692200,8978,3186,8978,2114,6864,6743,6483,166,32,54,0,8,121,6268,1195,5073,5005,4817,117,27,42,0,2,68,3186,2971,215,1172015601.88902,171558.665937
1036,48,339,692300,15803,5965,15803,5367,10436,10275,9014,764,95,350,19,33,161,11517,3284,8233,8139,7166,586,67,284,15,21,94,5965,5524,441,622372157.97869,142933.501351
1037,48,339,692400,8609,4029,8609,1723,6886,6727,5861,465,45,335,11,10,159,6550,1079,5471,5378,4751,330,33,246,11,7,93,4029,3730,299,184754029.813435,68812.29162
1038,48,339,692500,8331,3188,8331,1951,6380,6285,6017,192,38,29,4,5,95,5806,1131,4675,4637,4445,132,32,23,4,1,38,3188,2871,317,471382402.141775,101228.608249
1039,48,339,692601,4440,1470,4440,1793,2647,2609,2510,31,32,27,0,9,38,3030,1005,2025,1994,1914,27,25,23,0,5,31,1470,1361,109,149376945.860274,67859.160304
1040,48,339,692602,10150,3642,10150,3307,6843,6714,6389,216,35,68,1,5,129,7043,1914,5129,5072,4830,157,24,57,1,3,57,3642,3246,396,642036041.161723,112431.477109
1041,48,339,692700,7058,2639,7058,1323,5735,5666,5456,117,38,34,5,16,69,5131,780,4351,4299,4142,92,27,26,2,10,52,2639,2410,229,944829740.127216,142463.213741
1042,48,339,692801,8647,3237,8647,1252,7395,7282,7110,79,36,47,2,8,113,6210,713,5497,5434,5306,51,30,40,2,5,63,3237,2950,287,479649994.73509,103370.863588
1043,48,339,692802,3745,1379,3745,961,2784,2753,2618,84,33,14,0,4,31,2680,575,2105,2084,1992,63,19,9,0,1,21,1379,1237,142,421098276.973323,96380.357531
1044,48,339,692900,4518,1645,4518,804,3714,3672,3595,47,20,9,1,0,42,3228,470,2758,2729,2670,34,16,8,1,0,29,1645,1489,156,810495109.461149,117886.501855
1045,48,339,693000,10144,3405,10144,4345,5799,5712,5521,94,35,45,2,15,87,6753,2448,4305,4255,4124,60,23,37,2,9,50,3405,3099,306,1264731536.54903,158332.276061
1046,48,339,693101,6175,1968,6175,3566,2609,2544,1257,1219,18,25,0,25,65,4129,2223,1906,1874,978,853,12,22,0,9,32,1968,1819,149,49966660.68575,31283.231006
1047,48,339,693102,4189,1386,4189,2420,1769,1729,1335,339,13,39,0,3,40,2911,1498,1413,1391,1109,240,12,27,0,3,22,1386,1279,107,149370049.225611,70462.542032
1048,48,339,693200,7514,2701,7514,1331,6183,6077,5520,302,20,227,1,7,106,5593,799,4794,4736,4350,211,10,158,1,6,58,2701,2594,107,271529768.73941,78535.480158
1049,48,339,693300,6565,2846,6565,1406,5159,5077,4273,596,27,179,1,1,82,5024,892,4132,4080,3468,449,17,144,1,1,52,2846,2628,218,278408239.503087,79518.700955
1050,48,339,693400,4252,1562,4252,2407,1845,1783,951,778,9,38,3,4,62,2761,1555,1206,1189,678,468,7,32,0,4,17,1562,1414,148,28776522.075732,25910.446139
1051,48,339,693500,5633,2659,5633,1618,4015,3948,3419,456,13,54,0,6,67,4389,1043,3346,3310,2924,329,9,44,0,4,36,2659,2384,275,54857510.531682,31490.797611
1052,48,339,693600,2878,1872,2878,575,2303,2259,1885,306,12,55,0,1,44,2348,376,1972,1949,1665,225,11,47,0,1,23,1872,1407,465,69256126.965265,33804.942708
1053,48,339,693700,6834,3298,6834,749,6085,6014,5412,345,38,205,6,8,71,5361,504,4857,4822,4392,240,27,154,5,4,35,3298,2902,396,401706722.475394,102585.559565
1054,48,339,693800,3728,1430,3728,1263,2465,2415,1910,396,11,87,1,10,50,2626,789,1837,1816,1486,256,7,61,1,5,21,1430,1284,146,147886898.667948,54904.603259
1055,48,339,693900,11162,2908,11162,6935,4227,4184,3426,680,22,53,2,1,43,7948,4505,3443,3414,2826,524,19,42,2,1,29,2908,2647,261,435547377.227074,117268.102157
1056,48,339,694000,9070,3421,9070,1803,7267,7184,7041,88,18,35,1,1,83,6686,1095,5591,5539,5445,49,16,27,1,1,52,3421,3126,295,1349369201.8617,196722.915094
1057,48,339,694101,11249,4105,11249,3281,7968,7821,6781,955,41,32,3,9,147,7903,1885,6018,5954,5210,680,29,27,3,5,64,4105,3667,438,1660108462.02642,244738.591918
1058,48,339,694102,5731,2062,5731,1690,4041,3962,3682,239,24,10,0,7,79,4049,994,3055,3015,2809,173,23,8,0,2,40,2062,1918,144,433063315.494263,102714.572397
1059,48,339,694201,6786,3272,6786,960,5826,5750,5255,413,40,28,5,9,76,5077,560,4517,4475,4187,224,30,23,2,9,42,3272,2602,670,899990207.645499,129747.423407
1060,48,339,694202,10463,4796,10463,820,9643,9503,9118,204,52,107,11,11,140,8289,536,7753,7686,7410,138,37,86,8,7,67,4796,4246,550,592612897.073604,126492.371122
1061,48,339,694301,12302,6219,12302,818,11484,11342,10948,176,46,157,8,7,142,9621,519,9102,9042,8747,128,37,122,6,2,60,6219,4978,1241,537116958.506122,117445.606901
1062,48,339,694302,7656,3961,7656,519,7137,7049,6865,82,29,67,0,6,88,6106,343,5763,5706,5562,58,26,54,0,6,57,3961,3275,686,209144009.143977,100443.05316
1063,48,339,694400,7387,3157,7387,1006,6381,6285,5987,199,29,55,0,15,96,5547,626,4921,4869,4661,135,22,38,0,13,52,3157,2836,321,629390606.542292,137660.884984
1064,48,339,694500,6402,2261,6402,562,5840,5774,5543,108,35,79,2,7,66,4627,358,4269,4233,4073,79,21,54,2,4,36,2261,2153,108,1656939116.15204,251423.253233
1065,48,339,694600,6405,2594,6405,625,5780,5699,5070,575,36,16,0,2,81,4698,390,4308,4267,3807,414,31,13,0,2,41,2594,2319,275,2471860405.62619,248249.883051
1066,48,339,694700,3272,1539,3272,300,2972,2918,2673,196,21,20,3,5,54,2444,166,2278,2247,2073,138,18,11,3,4,31,1539,1245,294,3488017791.14022,267651.070306
1067,48,407,200101,6336,2658,6336,723,5613,5512,4764,652,39,53,1,3,101,4565,410,4155,4109,3518,516,32,40,1,2,46,2658,2238,420,2800358840.984,341580.369999
1068,48,407,200102,10069,4149,10069,1676,8393,8261,7498,692,34,28,2,7,132,7323,947,6376,6292,5692,546,27,23,2,2,84,4149,3533,616,7134539292.78855,491188.518535
1069,48,407,200200,5001,3074,5001,282,4719,4653,3929,664,23,32,4,1,66,3931,186,3745,3712,3201,474,20,15,2,0,33,3074,2059,1015,2901465252.12099,419905.20643
1070,48,407,200300,4978,3306,4978,199,4779,4701,4013,654,24,7,2,1,78,4239,150,4089,4030,3519,482,19,7,2,1,59,3306,2266,1040,4672260084.62801,360022.482504
1071,48,473,680100,2511,883,2511,688,1823,1801,1753,18,3,20,0,7,22,1775,441,1334,1325,1291,11,3,15,0,5,9,883,831,52,672916536.771008,130363.311934
1072,48,473,680200,9966,3668,9966,4573,5393,5290,3100,2109,24,41,0,16,103,7066,2809,4257,4203,2643,1494,19,32,0,15,54,3668,3196,472,4235577499.04042,342792.555886
1073,48,473,680300,10369,4289,10369,2715,7654,7527,4508,2942,20,48,1,8,127,7828,1664,6164,6092,3600,2439,14,35,1,3,72,4289,3814,475,2988078262.61741,347860.375338
1074,48,473,680400,3191,0,3191,109,3082,3031,29,2987,4,9,1,1,51,3180,109,3071,3021,29,2977,4,9,1,1,50,0,0,0,53507037.837283,32196.291344
1075,48,473,680500,9261,3866,9261,2956,6305,6227,3754,2355,55,44,3,16,78,6800,1801,4999,4951,3136,1724,43,36,1,11,48,3866,3389,477,4261751955.21357,593668.468871
1076,48,473,680600,7907,3133,7907,1495,6412,6338,6116,126,35,51,4,6,74,5900,931,4969,4924,4756,92,32,36,4,4,45,3133,2810,323,2222207281.5373,226417.394964
