OBJECTID_1,OBJECTID,STATE,COUNTY,TRACT,BLKGRP,SUM_POP100,SUM_HU100,SUM_TotPop,SUM_HispPo,SUM_NonHis,SUM_NHOneR,SUM_NH_Whi,SUM_NH_Bla,SUM_NH_AmI,SUM_NH_Asi,SUM_NH_Haw,SUM_NH_Oth,SUM_NH_2or,SUM_VAP_To,SUM_VAP_Hi,SUM_VAP_No,SUM_VAP_NH,SUM_VAP__1,SUM_VAP__2,SUM_VAP__3,SUM_VAP__4,SUM_VAP_Ha,SUM_VAP__5,SUM_VAP__6,SUM_TotHou,SUM_OccHU,SUM_Vacant,BG_ID,GEOID,BG_ID_1,Median_HHI
1,1,48,157,670101,1,1167,303,1167,841,326,320,54,252,1,9,0,4,6,776,553,223,222,51,161,1,8,0,1,1,303,286,17,481576701011,15000US481576701011,481576701011,45318
2,2,48,157,670101,2,1758,492,1758,1033,725,717,34,673,0,10,0,0,8,1184,660,524,522,31,483,0,8,0,0,2,492,467,25,481576701012,15000US481576701012,481576701012,33022
3,3,48,157,670101,3,2577,779,2577,1040,1537,1525,44,1455,6,13,0,7,12,1656,657,999,992,36,939,3,10,0,4,7,779,693,86,481576701013,15000US481576701013,481576701013,46979
4,4,48,157,670101,4,1272,339,1272,1024,248,244,50,189,1,0,0,4,4,831,650,181,180,46,133,1,0,0,0,1,339,318,21,481576701014,15000US481576701014,481576701014,51755
5,5,48,157,670102,1,2270,739,2270,940,1330,1321,35,1258,2,24,0,2,9,1568,603,965,959,29,905,2,21,0,2,6,739,693,46,481576701021,15000US481576701021,481576701021,35600
6,6,48,157,670102,2,1113,369,1113,230,883,878,12,857,0,4,0,5,5,767,145,622,618,10,601,0,4,0,3,4,369,352,17,481576701022,15000US481576701022,481576701022,69519
7,7,48,157,670200,1,960,312,960,250,710,700,53,631,2,14,0,0,10,695,156,539,535,45,474,2,14,0,0,4,312,294,18,481576702001,15000US481576702001,481576702001,59693
8,8,48,157,670200,2,1374,398,1374,958,416,402,110,266,5,19,0,2,14,977,642,335,332,106,201,5,19,0,1,3,398,380,18,481576702002,15000US481576702002,481576702002,41532
9,9,48,157,670200,3,1515,492,1515,563,952,941,27,897,1,16,0,0,11,1087,354,733,725,23,685,1,16,0,0,8,492,466,26,481576702003,15000US481576702003,481576702003,43571
10,10,48,157,670200,4,2682,788,2682,1040,1642,1633,36,1575,1,14,1,6,9,1843,637,1206,1200,31,1152,0,12,1,4,6,788,750,38,481576702004,15000US481576702004,481576702004,66250
11,11,48,157,670200,5,1791,576,1791,423,1368,1365,27,1332,6,0,0,0,3,1237,264,973,970,21,946,3,0,0,0,3,576,550,26,481576702005,15000US481576702005,481576702005,73750
12,12,48,157,670300,1,1831,596,1831,583,1248,1233,53,1161,0,16,0,3,15,1273,346,927,921,48,857,0,15,0,1,6,596,559,37,481576703001,15000US481576703001,481576703001,43088
13,13,48,157,670300,2,1970,664,1970,267,1703,1664,26,1631,0,2,0,5,39,1460,158,1302,1283,19,1261,0,2,0,1,19,664,631,33,481576703002,15000US481576703002,481576703002,59797
14,14,48,157,670400,1,1764,646,1764,163,1601,1588,23,1540,4,18,1,2,13,1193,92,1101,1098,17,1060,1,17,1,2,3,646,629,17,481576704001,15000US481576704001,481576704001,33482
15,15,48,157,670400,2,1052,378,1052,148,904,894,7,883,0,0,0,4,10,757,97,660,654,6,648,0,0,0,0,6,378,349,29,481576704002,15000US481576704002,481576704002,52375
16,16,48,157,670400,3,2242,793,2242,431,1811,1785,50,1719,3,7,0,6,26,1619,275,1344,1331,44,1274,3,7,0,3,13,793,736,57,481576704003,15000US481576704003,481576704003,59000
17,17,48,157,670500,1,0,0,0,0,0,0,0,0,0,0,0,0,0,0,0,0,0,0,0,0,0,0,0,0,0,0,0,481576705001,15000US481576705001,481576705001,85332
18,18,48,157,670500,2,0,0,0,0,0,0,0,0,0,0,0,0,0,0,0,0,0,0,0,0,0,0,0,0,0,0,0,481576705002,15000US481576705002,481576705002,51982
19,19,48,157,670601,1,1774,607,1774,130,1644,1625,45,1569,1,4,0,6,19,1312,71,1241,1234,38,1189,1,4,0,2,7,607,583,24,481576706011,15000US481576706011,481576706011,82550
20,20,48,157,670601,3,1114,390,1114,107,1007,995,20,968,2,5,0,0,12,803,70,733,723,18,699,1,5,0,0,10,390,371,19,481576706013,15000US481576706013,481576706013,61489
21,21,48,157,670601,4,351,120,351,48,303,301,3,295,0,3,0,0,2,232,32,200,199,3,193,0,3,0,0,1,120,115,5,481576706014,15000US481576706014,481576706014,75037
22,22,48,157,670602,1,1907,652,1907,508,1399,1393,36,1323,8,16,0,10,6,1349,328,1021,1017,31,963,4,14,0,5,4,652,605,47,481576706021,15000US481576706021,481576706021,57279
23,23,48,157,670700,1,1506,514,1506,125,1381,1367,38,1302,2,23,0,2,14,1064,77,987,982,36,923,2,20,0,1,5,514,487,27,481576707001,15000US481576707001,481576707001,49856
24,24,48,157,671900,1,0,0,0,0,0,0,0,0,0,0,0,0,0,0,0,0,0,0,0,0,0,0,0,0,0,0,0,481576719001,15000US481576719001,481576719001,105833
25,25,48,157,672001,3,2076,843,2076,699,1377,1323,359,439,5,510,1,9,54,1528,455,1073,1039,297,336,4,398,0,4,34,843,799,44,481576720013,15000US481576720013,481576720013,39085
26,26,48,157,672301,1,0,0,0,0,0,0,0,0,0,0,0,0,0,0,0,0,0,0,0,0,0,0,0,0,0,0,0,481576723011,15000US481576723011,481576723011,67365
27,27,48,157,672400,1,115,30,115,12,103,99,0,62,0,37,0,0,4,83,8,75,71,0,40,0,31,0,0,4,30,30,0,481576724001,15000US481576724001,481576724001,77552
28,28,48,157,672400,2,31,10,31,8,23,23,14,6,3,0,0,0,0,20,5,15,15,8,4,3,0,0,0,0,10,10,0,481576724002,15000US481576724002,481576724002,55914
29,29,48,157,672500,3,0,0,0,0,0,0,0,0,0,0,0,0,0,0,0,0,0,0,0,0,0,0,0,0,0,0,0,481576725003,15000US481576725003,481576725003,85714
30,30,48,157,672601,2,4,1,4,4,0,0,0,0,0,0,0,0,0,4,4,0,0,0,0,0,0,0,0,0,1,1,0,481576726012,15000US481576726012,481576726012,61063
31,31,48,157,672601,5,9,3,9,7,2,2,0,2,0,0,0,0,0,6,4,2,2,0,2,0,0,0,0,0,3,3,0,481576726015,15000US481576726015,481576726015,42467
32,32,48,157,672701,1,3,1,3,0,3,3,0,0,0,3,0,0,0,3,0,3,3,0,0,0,3,0,0,0,1,1,0,481576727011,15000US481576727011,481576727011,84429
33,33,48,157,672701,2,6,3,6,5,1,1,0,0,0,1,0,0,0,4,3,1,1,0,0,0,1,0,0,0,3,3,0,481576727012,15000US481576727012,481576727012,78142
34,34,48,157,672900,1,825,298,825,229,596,576,278,167,1,130,0,0,20,580,148,432,425,213,114,1,97,0,0,7,298,278,20,481576729001,15000US481576729001,481576729001,74558
35,35,48,157,673001,2,9,4,9,1,8,8,6,0,0,2,0,0,0,9,1,8,8,6,0,0,2,0,0,0,4,4,0,481576730012,15000US481576730012,481576730012,147045
36,36,48,157,673002,1,480,143,480,85,395,379,285,18,0,74,0,2,16,293,49,244,235,179,9,0,46,0,1,9,143,139,4,481576730021,15000US481576730021,481576730021,121855
37,37,48,157,673002,2,0,0,0,0,0,0,0,0,0,0,0,0,0,0,0,0,0,0,0,0,0,0,0,0,0,0,0,481576730022,15000US481576730022,481576730022,132813
38,38,48,157,673003,1,0,0,0,0,0,0,0,0,0,0,0,0,0,0,0,0,0,0,0,0,0,0,0,0,0,0,0,481576730031,15000US481576730031,481576730031,152800
39,39,48,157,673003,2,61,17,61,8,53,52,32,0,1,19,0,0,1,37,4,33,33,19,0,1,13,0,0,0,17,17,0,481576730032,15000US481576730032,481576730032,117425
40,40,48,157,673102,1,479,256,479,109,370,365,288,24,0,52,1,0,5,329,58,271,269,219,15,0,34,1,0,2,256,210,46,481576731021,15000US481576731021,481576731021,120298
41,41,48,157,673102,2,36,13,36,6,30,28,11,4,0,13,0,0,2,24,4,20,19,7,4,0,8,0,0,1,13,12,1,481576731022,15000US481576731022,481576731022,135565
42,42,48,157,673400,1,0,0,0,0,0,0,0,0,0,0,0,0,0,0,0,0,0,0,0,0,0,0,0,0,0,0,0,481576734001,15000US481576734001,481576734001,131327
43,43,48,201,100000,1,3031,778,3031,898,2133,2115,924,843,13,47,0,288,18,2964,882,2082,2065,899,822,13,43,0,288,17,778,546,232,482011000001,15000US482011000001,482011000001,25685
44,44,48,201,100000,2,544,555,544,75,469,459,291,135,2,25,1,5,10,523,68,455,448,288,130,2,24,1,3,7,555,416,139,482011000002,15000US482011000002,482011000002,32837
45,45,48,201,100000,3,1115,989,1115,97,1018,1007,867,69,7,62,0,2,11,1073,82,991,984,854,62,7,59,0,2,7,989,775,214,482011000003,15000US482011000003,482011000003,102824
46,46,48,201,210100,1,9652,87,9652,1788,7864,7845,2893,4881,3,58,0,10,19,9469,1747,7722,7704,2839,4795,3,57,0,10,18,87,72,15,482012101001,15000US482012101001,482012101001,87375
47,47,48,201,210400,1,986,349,986,868,118,115,9,94,3,2,1,6,3,670,580,90,90,7,75,3,2,1,2,0,349,282,67,482012104001,15000US482012104001,482012104001,23854
48,48,48,201,210400,2,721,249,721,675,46,42,28,13,0,1,0,0,4,507,464,43,41,27,13,0,1,0,0,2,249,218,31,482012104002,15000US482012104002,482012104002,21184
49,49,48,201,210400,3,2557,895,2557,1775,782,771,108,646,3,11,0,3,11,1629,1221,408,406,87,306,3,7,0,3,2,895,824,71,482012104003,15000US482012104003,482012104003,24552
50,50,48,201,210400,4,1064,308,1064,707,357,350,187,151,3,9,0,0,7,837,502,335,329,173,145,3,8,0,0,6,308,269,39,482012104004,15000US482012104004,482012104004,29554
51,51,48,201,210500,1,1399,486,1399,1317,82,80,55,24,0,1,0,0,2,1005,932,73,71,50,20,0,1,0,0,2,486,432,54,482012105001,15000US482012105001,482012105001,36331
52,52,48,201,210500,2,1838,653,1838,1425,413,410,67,332,4,4,0,3,3,1291,963,328,326,56,261,4,4,0,1,2,653,560,93,482012105002,15000US482012105002,482012105002,29231
53,53,48,201,210500,3,1645,554,1645,1354,291,287,103,179,2,1,0,2,4,1178,968,210,208,89,114,2,1,0,2,2,554,512,42,482012105003,15000US482012105003,482012105003,22227
54,54,48,201,210600,1,859,323,859,685,174,171,154,11,3,3,0,0,3,632,476,156,153,142,5,3,3,0,0,3,323,295,28,482012106001,15000US482012106001,482012106001,31522
55,55,48,201,210600,2,1243,605,1243,881,362,350,310,27,2,10,0,1,12,1011,683,328,319,282,25,2,9,0,1,9,605,519,86,482012106002,15000US482012106002,482012106002,60056
56,56,48,201,210600,3,1714,675,1714,1442,272,260,214,29,3,9,1,4,12,1315,1068,247,237,192,28,3,9,1,4,10,675,635,40,482012106003,15000US482012106003,482012106003,47212
57,57,48,201,210600,4,1681,656,1681,1370,311,308,257,29,6,14,0,2,3,1251,977,274,271,235,17,5,12,0,2,3,656,588,68,482012106004,15000US482012106004,482012106004,29270
58,58,48,201,210700,1,733,250,733,573,160,156,25,127,2,1,0,1,4,530,398,132,130,22,104,2,1,0,1,2,250,217,33,482012107001,15000US482012107001,482012107001,33571
59,59,48,201,210700,2,959,330,959,701,258,252,34,215,0,1,2,0,6,662,465,197,194,25,166,0,1,2,0,3,330,292,38,482012107002,15000US482012107002,482012107002,30192
60,60,48,201,210700,3,793,285,793,617,176,175,26,147,1,1,0,0,1,569,425,144,143,23,118,1,1,0,0,1,285,245,40,482012107003,15000US482012107003,482012107003,56029
61,61,48,201,210800,1,1382,556,1382,730,652,649,36,608,0,0,0,5,3,954,434,520,517,25,491,0,0,0,1,3,556,460,96,482012108001,15000US482012108001,482012108001,17250
62,62,48,201,210800,2,1371,550,1371,998,373,364,15,345,3,1,0,0,9,993,679,314,307,12,293,1,1,0,0,7,550,431,119,482012108002,15000US482012108002,482012108002,19091
63,63,48,201,210900,1,983,438,983,257,726,721,28,672,2,19,0,0,5,760,159,601,598,26,552,2,18,0,0,3,438,351,87,482012109001,15000US482012109001,482012109001,19966
64,64,48,201,210900,2,637,293,637,105,532,532,7,523,1,1,0,0,0,487,62,425,425,5,419,1,0,0,0,0,293,247,46,482012109002,15000US482012109002,482012109002,49667
65,65,48,201,211000,1,856,382,856,215,641,634,9,605,1,14,0,5,7,641,133,508,503,7,486,1,6,0,3,5,382,328,54,482012110001,15000US482012110001,482012110001,12456
66,66,48,201,211000,2,1183,511,1183,355,828,822,29,782,1,9,0,1,6,886,229,657,653,28,617,1,6,0,1,4,511,449,62,482012110002,15000US482012110002,482012110002,14830
67,67,48,201,211100,1,1374,605,1374,467,907,902,21,872,3,0,5,1,5,1017,292,725,723,16,700,3,0,3,1,2,605,499,106,482012111001,15000US482012111001,482012111001,14874
68,68,48,201,211100,2,788,290,788,438,350,346,8,338,0,0,0,0,4,529,272,257,253,7,246,0,0,0,0,4,290,240,50,482012111002,15000US482012111002,482012111002,15410
69,69,48,201,211100,3,865,367,865,377,488,481,2,473,0,6,0,0,7,638,237,401,398,2,390,0,6,0,0,3,367,298,69,482012111003,15000US482012111003,482012111003,13889
70,70,48,201,211100,4,802,286,802,656,146,144,2,142,0,0,0,0,2,579,466,113,112,2,110,0,0,0,0,1,286,248,38,482012111004,15000US482012111004,482012111004,28780
71,71,48,201,211100,5,860,305,860,389,471,464,8,450,5,0,0,1,7,573,230,343,337,8,323,5,0,0,1,6,305,263,42,482012111005,15000US482012111005,482012111005,28500
72,72,48,201,211100,6,1315,503,1315,829,486,479,11,457,9,2,0,0,7,887,513,374,367,7,350,8,2,0,0,7,503,406,97,482012111006,15000US482012111006,482012111006,21465
73,73,48,201,211200,1,829,453,829,152,677,673,15,655,1,1,0,1,4,639,97,542,538,11,525,0,1,0,1,4,453,344,109,482012112001,15000US482012112001,482012112001,18490
74,74,48,201,211200,2,1245,612,1245,330,915,909,5,892,3,7,1,1,6,895,188,707,701,5,688,3,3,1,1,6,612,488,124,482012112002,15000US482012112002,482012112002,30147
75,75,48,201,211200,3,757,318,757,469,288,284,9,274,0,1,0,0,4,566,336,230,226,9,216,0,1,0,0,4,318,255,63,482012112003,15000US482012112003,482012112003,22986
76,76,48,201,211300,1,766,439,766,177,589,584,26,556,2,0,0,0,5,596,116,480,476,26,448,2,0,0,0,4,439,372,67,482012113001,15000US482012113001,482012113001,6679
77,77,48,201,211300,2,1423,603,1423,392,1031,1017,29,987,0,0,0,1,14,872,223,649,641,18,623,0,0,0,0,8,603,488,115,482012113002,15000US482012113002,482012113002,13594
78,78,48,201,211300,3,1003,456,1003,268,735,730,45,680,0,0,0,5,5,762,175,587,584,44,535,0,0,0,5,3,456,335,121,482012113003,15000US482012113003,482012113003,23409
79,79,48,201,211300,4,1086,525,1086,315,771,768,5,762,0,0,0,1,3,797,204,593,591,4,586,0,0,0,1,2,525,397,128,482012113004,15000US482012113004,482012113004,18359
80,80,48,201,211300,5,768,362,768,249,519,512,8,499,1,0,1,3,7,550,150,400,397,8,386,1,0,1,1,3,362,266,96,482012113005,15000US482012113005,482012113005,23546
81,81,48,201,211400,1,1088,459,1088,384,704,701,17,671,6,7,0,0,3,760,240,520,517,15,495,4,3,0,0,3,459,378,81,482012114001,15000US482012114001,482012114001,42500
82,82,48,201,211400,2,1440,542,1440,339,1101,1096,49,1043,1,3,0,0,5,856,188,668,665,44,617,1,3,0,0,3,542,479,63,482012114002,15000US482012114002,482012114002,15882
83,83,48,201,211400,3,1162,536,1162,587,575,565,222,272,5,60,5,1,10,910,408,502,496,212,224,2,55,2,1,6,536,459,77,482012114003,15000US482012114003,482012114003,87096
84,84,48,201,211500,1,1216,359,1216,1183,33,33,23,10,0,0,0,0,0,840,821,19,19,14,5,0,0,0,0,0,359,322,37,482012115001,15000US482012115001,482012115001,30875
85,85,48,201,211500,2,2190,687,2190,1862,328,321,84,220,5,9,2,1,7,1509,1256,253,247,65,170,4,5,2,1,6,687,631,56,482012115002,15000US482012115002,482012115002,36569
86,86,48,201,211500,3,1703,527,1703,1613,90,87,84,2,1,0,0,0,3,1169,1100,69,66,63,2,1,0,0,0,3,527,463,64,482012115003,15000US482012115003,482012115003,34257
87,87,48,201,211500,4,835,258,835,787,48,48,40,7,0,1,0,0,0,583,543,40,40,34,5,0,1,0,0,0,258,226,32,482012115004,15000US482012115004,482012115004,35687
88,88,48,201,211500,5,963,285,963,918,45,45,39,2,0,1,0,3,0,632,598,34,34,30,2,0,1,0,1,0,285,256,29,482012115005,15000US482012115005,482012115005,19760
89,89,48,201,211600,1,1139,580,1139,978,161,160,42,116,2,0,0,0,1,824,689,135,134,36,97,1,0,0,0,1,580,361,219,482012116001,15000US482012116001,482012116001,31765
90,90,48,201,211600,2,1672,588,1672,1315,357,353,58,276,9,6,0,4,4,1160,883,277,274,47,211,7,5,0,4,3,588,497,91,482012116002,15000US482012116002,482012116002,31667
91,91,48,201,211700,1,1511,672,1511,210,1301,1291,8,1281,1,0,1,0,10,1136,127,1009,1001,6,994,0,0,1,0,8,672,593,79,482012117001,15000US482012117001,482012117001,29496
92,92,48,201,211700,2,1033,370,1033,531,502,490,16,472,0,0,1,1,12,748,351,397,391,13,376,0,0,1,1,6,370,324,46,482012117002,15000US482012117002,482012117002,17396
93,93,48,201,211700,3,1342,611,1342,464,878,871,18,834,9,5,0,5,7,968,301,667,662,16,636,5,3,0,2,5,611,491,120,482012117003,15000US482012117003,482012117003,21292
94,94,48,201,211900,1,1517,455,1517,1464,53,53,35,14,2,1,0,1,0,1036,994,42,42,30,9,1,1,0,1,0,455,409,46,482012119001,15000US482012119001,482012119001,32857
95,95,48,201,211900,2,1401,412,1401,1367,34,33,29,4,0,0,0,0,1,932,905,27,26,23,3,0,0,0,0,1,412,374,38,482012119002,15000US482012119002,482012119002,28616
96,96,48,201,211900,3,1300,405,1300,1253,47,46,37,4,3,2,0,0,1,848,804,44,43,37,2,3,1,0,0,1,405,360,45,482012119003,15000US482012119003,482012119003,31350
97,97,48,201,211900,4,1007,295,1007,973,34,34,23,1,1,6,0,3,0,710,685,25,25,20,1,1,2,0,1,0,295,274,21,482012119004,15000US482012119004,482012119004,30031
98,98,48,201,212300,1,1107,390,1107,988,119,119,74,40,1,3,0,1,0,798,693,105,105,69,31,1,3,0,1,0,390,339,51,482012123001,15000US482012123001,482012123001,21161
99,99,48,201,212300,2,972,339,972,894,78,76,57,13,1,4,0,1,2,690,624,66,64,46,13,1,4,0,0,2,339,296,43,482012123002,15000US482012123002,482012123002,29453
100,100,48,201,212300,3,676,335,676,493,183,180,32,146,0,1,0,1,3,467,311,156,153,32,119,0,1,0,1,3,335,234,101,482012123003,15000US482012123003,482012123003,12368
101,101,48,201,212300,4,1401,534,1401,1326,75,71,35,28,6,2,0,0,4,987,922,65,64,30,26,6,2,0,0,1,534,436,98,482012123004,15000US482012123004,482012123004,24107
102,102,48,201,212300,5,1225,468,1225,1107,118,114,90,18,1,5,0,0,4,909,803,106,104,81,18,1,4,0,0,2,468,394,74,482012123005,15000US482012123005,482012123005,20809
103,103,48,201,212400,1,1479,474,1479,1402,77,74,43,25,0,5,0,1,3,1022,953,69,67,41,20,0,5,0,1,2,474,428,46,482012124001,15000US482012124001,482012124001,28622
104,104,48,201,212400,2,897,291,897,704,193,193,25,156,12,0,0,0,0,639,474,165,165,22,132,11,0,0,0,0,291,266,25,482012124002,15000US482012124002,482012124002,33023
105,105,48,201,212400,3,840,277,840,813,27,25,14,5,0,2,0,4,2,593,568,25,23,14,5,0,2,0,2,2,277,244,33,482012124003,15000US482012124003,482012124003,15313
106,106,48,201,212500,1,1187,429,1187,675,512,506,11,488,4,2,0,1,6,866,450,416,410,11,392,4,2,0,1,6,429,378,51,482012125001,15000US482012125001,482012125001,32067
107,107,48,201,212500,2,1432,656,1432,196,1236,1222,14,1200,0,5,1,2,14,1137,122,1015,1004,8,994,0,0,0,2,11,656,588,68,482012125002,15000US482012125002,482012125002,30615
108,108,48,201,212500,3,991,481,991,144,847,835,15,816,0,1,0,3,12,807,83,724,717,13,701,0,1,0,2,7,481,428,53,482012125003,15000US482012125003,482012125003,32837
109,109,48,201,220100,1,1394,488,1394,689,705,694,25,660,6,1,0,2,11,952,431,521,514,17,491,4,1,0,1,7,488,423,65,482012201001,15000US482012201001,482012201001,24007
110,110,48,201,220100,2,703,237,703,349,354,353,14,336,3,0,0,0,1,495,216,279,278,5,270,3,0,0,0,1,237,210,27,482012201002,15000US482012201002,482012201002,37703
111,111,48,201,220200,1,1951,630,1951,1794,157,155,129,22,4,0,0,0,2,1374,1233,141,139,119,18,2,0,0,0,2,630,577,53,482012202001,15000US482012202001,482012202001,24318
112,112,48,201,220200,2,1079,386,1079,1005,74,74,58,14,1,1,0,0,0,778,711,67,67,55,10,1,1,0,0,0,386,329,57,482012202002,15000US482012202002,482012202002,28024
113,113,48,201,220300,1,1136,381,1136,1014,122,120,80,21,1,13,0,5,2,800,691,109,109,76,18,1,10,0,4,0,381,349,32,482012203001,15000US482012203001,482012203001,29176
114,114,48,201,220300,2,976,287,976,898,78,77,69,7,0,1,0,0,1,660,594,66,65,59,5,0,1,0,0,1,287,262,25,482012203002,15000US482012203002,482012203002,37404
115,115,48,201,220300,3,2397,753,2397,2165,232,230,199,27,1,1,0,2,2,1672,1468,204,203,178,22,1,1,0,1,1,753,687,66,482012203003,15000US482012203003,482012203003,33750
116,116,48,201,220400,1,1448,430,1448,1240,208,205,52,147,1,5,0,0,3,879,753,126,125,44,77,1,3,0,0,1,430,392,38,482012204001,15000US482012204001,482012204001,32933
117,117,48,201,220400,2,2468,753,2468,2268,200,197,164,30,0,2,0,1,3,1692,1516,176,173,148,22,0,2,0,1,3,753,668,85,482012204002,15000US482012204002,482012204002,26789
118,118,48,201,220400,3,1105,306,1105,999,106,101,82,14,3,2,0,0,5,754,662,92,89,74,12,1,2,0,0,3,306,293,13,482012204003,15000US482012204003,482012204003,33006
119,119,48,201,220500,1,920,326,920,824,96,92,65,26,0,1,0,0,4,677,590,87,85,59,25,0,1,0,0,2,326,299,27,482012205001,15000US482012205001,482012205001,28105
120,120,48,201,220500,2,1964,752,1964,1471,493,480,355,122,2,1,0,0,13,1439,995,444,433,328,102,2,1,0,0,11,752,712,40,482012205002,15000US482012205002,482012205002,25636
121,121,48,201,220500,3,1404,865,1404,854,550,544,165,360,1,17,0,1,6,1194,653,541,535,156,360,1,17,0,1,6,865,809,56,482012205003,15000US482012205003,482012205003,14273
122,122,48,201,220600,1,2850,861,2850,1996,854,851,157,682,6,4,0,2,3,1769,1301,468,466,120,336,4,4,0,2,2,861,786,75,482012206001,15000US482012206001,482012206001,31719
123,123,48,201,220600,2,1044,288,1044,941,103,101,87,12,0,1,1,0,2,700,611,89,89,77,10,0,1,1,0,0,288,265,23,482012206002,15000US482012206002,482012206002,49408
124,124,48,201,220700,1,1176,451,1176,754,422,418,80,330,1,2,0,5,4,798,470,328,324,69,252,0,1,0,2,4,451,410,41,482012207001,15000US482012207001,482012207001,24167
125,125,48,201,220700,2,953,315,953,767,186,185,19,166,0,0,0,0,1,674,508,166,165,16,149,0,0,0,0,1,315,276,39,482012207002,15000US482012207002,482012207002,30688
126,126,48,201,220700,3,746,257,746,543,203,203,3,200,0,0,0,0,0,532,362,170,170,3,167,0,0,0,0,0,257,221,36,482012207003,15000US482012207003,482012207003,40403
127,127,48,201,220700,4,1403,452,1403,1105,298,285,19,238,5,21,0,2,13,934,700,234,227,18,195,5,9,0,0,7,452,401,51,482012207004,15000US482012207004,482012207004,25873
128,128,48,201,220700,5,2039,611,2039,1313,726,724,80,637,4,2,0,1,2,1260,838,422,421,65,350,4,2,0,0,1,611,558,53,482012207005,15000US482012207005,482012207005,14956
129,129,48,201,220800,1,1152,381,1152,926,226,223,15,206,0,0,0,2,3,735,547,188,187,14,171,0,0,0,2,1,381,326,55,482012208001,15000US482012208001,482012208001,26792
130,130,48,201,220800,2,2137,854,2137,649,1488,1479,54,1406,6,12,0,1,9,1383,376,1007,1002,49,940,3,9,0,1,5,854,758,96,482012208002,15000US482012208002,482012208002,11652
131,131,48,201,220900,1,857,235,857,641,216,210,29,171,1,6,0,3,6,532,402,130,128,28,92,1,4,0,3,2,235,200,35,482012209001,15000US482012209001,482012209001,34049
132,132,48,201,220900,2,995,315,995,858,137,136,20,105,2,9,0,0,1,681,575,106,105,18,77,1,9,0,0,1,315,280,35,482012209002,15000US482012209002,482012209002,34945
133,133,48,201,221000,1,1768,539,1768,1158,610,598,208,378,0,6,0,6,12,1213,740,473,464,178,278,0,4,0,4,9,539,421,118,482012210001,15000US482012210001,482012210001,35848
134,134,48,201,221000,2,2269,648,2269,1990,279,275,118,150,1,1,0,5,4,1466,1253,213,211,106,101,1,1,0,2,2,648,553,95,482012210002,15000US482012210002,482012210002,27617
135,135,48,201,221100,1,1462,443,1462,1306,156,156,131,12,3,10,0,0,0,976,841,135,135,115,7,3,10,0,0,0,443,398,45,482012211001,15000US482012211001,482012211001,32232
136,136,48,201,221100,2,1195,333,1195,1065,130,129,117,11,0,1,0,0,1,774,674,100,99,93,5,0,1,0,0,1,333,300,33,482012211002,15000US482012211002,482012211002,27969
137,137,48,201,221100,3,941,270,941,832,109,109,66,19,2,18,0,4,0,627,529,98,98,62,19,2,14,0,1,0,270,242,28,482012211003,15000US482012211003,482012211003,42667
138,138,48,201,221200,1,1923,568,1923,1617,306,302,263,35,4,0,0,0,4,1310,1037,273,270,238,28,4,0,0,0,3,568,519,49,482012212001,15000US482012212001,482012212001,45972
139,139,48,201,221200,2,1069,303,1069,968,101,99,83,14,1,0,0,1,2,714,625,89,87,76,10,1,0,0,0,2,303,282,21,482012212002,15000US482012212002,482012212002,37845
140,140,48,201,221200,3,3002,828,3002,2599,403,395,344,42,1,5,2,1,8,2023,1685,338,333,294,31,1,5,1,1,5,828,778,50,482012212003,15000US482012212003,482012212003,29556
141,141,48,201,221300,1,1826,537,1826,1683,143,141,92,28,0,13,3,5,2,1218,1104,114,113,76,20,0,13,3,1,1,537,498,39,482012213001,15000US482012213001,482012213001,41108
142,142,48,201,221300,2,879,245,879,764,115,113,92,18,3,0,0,0,2,570,473,97,95,79,15,1,0,0,0,2,245,226,19,482012213002,15000US482012213002,482012213002,35882
143,143,48,201,221300,3,1181,343,1181,1083,98,96,81,11,1,2,0,1,2,786,695,91,91,78,10,0,2,0,1,0,343,320,23,482012213003,15000US482012213003,482012213003,40771
144,144,48,201,221300,4,2252,646,2252,2035,217,215,193,18,1,1,0,2,2,1518,1325,193,191,176,13,1,1,0,0,2,646,597,49,482012213004,15000US482012213004,482012213004,41641
145,145,48,201,221300,5,2455,672,2455,2153,302,286,242,34,2,8,0,0,16,1639,1383,256,247,212,26,2,7,0,0,9,672,613,59,482012213005,15000US482012213005,482012213005,36764
146,146,48,201,221400,1,1090,308,1090,971,119,112,58,53,0,1,0,0,7,705,616,89,88,48,39,0,1,0,0,1,308,286,22,482012214001,15000US482012214001,482012214001,33750
147,147,48,201,221400,2,2201,661,2201,1959,242,237,209,18,1,8,0,1,5,1466,1249,217,216,192,15,1,8,0,0,1,661,608,53,482012214002,15000US482012214002,482012214002,37632
148,148,48,201,221400,3,2846,1019,2846,2540,306,299,201,90,3,0,0,5,7,1883,1625,258,253,184,63,3,0,0,3,5,1019,840,179,482012214003,15000US482012214003,482012214003,26739
149,149,48,201,221500,1,2957,833,2957,2642,315,307,225,64,1,13,0,4,8,1932,1664,268,260,202,43,1,13,0,1,8,833,787,46,482012215001,15000US482012215001,482012215001,30714
150,150,48,201,221500,2,2975,1047,2975,1822,1153,1134,94,1025,0,12,1,2,19,1925,1188,737,726,73,640,0,11,1,1,11,1047,939,108,482012215002,15000US482012215002,482012215002,17591
151,151,48,201,221500,3,2327,694,2327,1876,451,450,264,168,2,8,0,8,1,1646,1237,409,408,238,154,2,8,0,6,1,694,651,43,482012215003,15000US482012215003,482012215003,40060
152,152,48,201,221600,1,619,163,619,509,110,109,90,17,0,2,0,0,1,408,306,102,101,84,15,0,2,0,0,1,163,153,10,482012216001,15000US482012216001,482012216001,62279
153,153,48,201,221600,3,1527,410,1527,1270,257,248,202,17,1,25,0,3,9,1018,800,218,214,181,10,1,20,0,2,4,410,395,15,482012216003,15000US482012216003,482012216003,36683
154,154,48,201,221600,4,45,16,45,25,20,17,7,9,0,1,0,0,3,31,15,16,15,7,7,0,1,0,0,1,16,16,0,482012216004,15000US482012216004,482012216004,40378
155,155,48,201,221700,1,1423,384,1423,1242,181,176,143,13,5,9,0,6,5,963,803,160,158,129,11,5,8,0,5,2,384,353,31,482012217001,15000US482012217001,482012217001,34534
156,156,48,201,221700,2,2203,649,2203,1987,216,215,180,24,1,7,1,2,1,1461,1272,189,188,159,18,1,7,1,2,1,649,585,64,482012217002,15000US482012217002,482012217002,50029
157,157,48,201,221700,3,719,191,719,588,131,130,109,16,0,5,0,0,1,490,376,114,114,97,13,0,4,0,0,0,191,183,8,482012217003,15000US482012217003,482012217003,47917
158,158,48,201,221800,1,0,0,0,0,0,0,0,0,0,0,0,0,0,0,0,0,0,0,0,0,0,0,0,0,0,0,0,482012218001,15000US482012218001,482012218001,35218
159,159,48,201,221800,2,16,8,16,15,1,1,1,0,0,0,0,0,0,15,14,1,1,1,0,0,0,0,0,0,8,6,2,482012218002,15000US482012218002,482012218002,46304
160,160,48,201,221900,1,0,0,0,0,0,0,0,0,0,0,0,0,0,0,0,0,0,0,0,0,0,0,0,0,0,0,0,482012219001,15000US482012219001,482012219001,35066
161,161,48,201,221900,2,0,0,0,0,0,0,0,0,0,0,0,0,0,0,0,0,0,0,0,0,0,0,0,0,0,0,0,482012219002,15000US482012219002,482012219002,52083
162,162,48,201,221900,3,0,0,0,0,0,0,0,0,0,0,0,0,0,0,0,0,0,0,0,0,0,0,0,0,0,0,0,482012219003,15000US482012219003,482012219003,27143
163,163,48,201,222000,1,2435,586,2435,2089,346,334,213,113,7,1,0,0,12,1693,1386,307,298,193,99,5,1,0,0,9,586,557,29,482012220001,15000US482012220001,482012220001,30625
164,164,48,201,222100,2,0,0,0,0,0,0,0,0,0,0,0,0,0,0,0,0,0,0,0,0,0,0,0,0,0,0,0,482012221002,15000US482012221002,482012221002,33512
165,165,48,201,222300,1,119,33,119,106,13,13,13,0,0,0,0,0,0,72,66,6,6,6,0,0,0,0,0,0,33,33,0,482012223001,15000US482012223001,482012223001,46619
166,166,48,201,222300,2,0,0,0,0,0,0,0,0,0,0,0,0,0,0,0,0,0,0,0,0,0,0,0,0,0,0,0,482012223002,15000US482012223002,482012223002,50129
167,167,48,201,222300,3,0,0,0,0,0,0,0,0,0,0,0,0,0,0,0,0,0,0,0,0,0,0,0,0,0,0,0,482012223003,15000US482012223003,482012223003,43806
168,168,48,201,222401,2,391,126,391,308,83,83,54,5,0,22,0,2,0,265,199,66,66,48,4,0,14,0,0,0,126,100,26,482012224012,15000US482012224012,482012224012,32985
169,169,48,201,222402,1,0,0,0,0,0,0,0,0,0,0,0,0,0,0,0,0,0,0,0,0,0,0,0,0,0,0,0,482012224021,15000US482012224021,482012224021,38810
170,170,48,201,222501,1,1011,381,1011,873,138,137,29,94,0,13,0,1,1,658,559,99,98,27,63,0,7,0,1,1,381,279,102,482012225011,15000US482012225011,482012225011,21613
171,171,48,201,222501,2,1849,493,1849,1637,212,208,139,62,0,4,3,0,4,1286,1097,189,186,130,49,0,4,3,0,3,493,477,16,482012225012,15000US482012225012,482012225012,32531
172,172,48,201,222502,1,5,1,5,1,4,4,4,0,0,0,0,0,0,2,1,1,1,1,0,0,0,0,0,0,1,1,0,482012225021,15000US482012225021,482012225021,31803
173,173,48,201,222502,2,2486,636,2486,2045,441,431,291,133,0,7,0,0,10,1661,1303,358,350,252,91,0,7,0,0,8,636,618,18,482012225022,15000US482012225022,482012225022,55688
174,174,48,201,222503,1,2239,550,2239,1984,255,255,173,64,4,14,0,0,0,1512,1289,223,223,162,45,3,13,0,0,0,550,531,19,482012225031,15000US482012225031,482012225031,46118
175,175,48,201,222503,2,2062,678,2062,1974,88,84,38,40,0,2,1,3,4,1352,1281,71,67,31,32,0,2,1,1,4,678,570,108,482012225032,15000US482012225032,482012225032,27617
176,176,48,201,222503,3,2313,742,2313,1860,453,440,110,320,0,9,0,1,13,1507,1167,340,331,98,223,0,9,0,1,9,742,617,125,482012225033,15000US482012225033,482012225033,38027
177,177,48,201,222600,1,2716,1349,2716,1897,819,808,75,710,4,15,1,3,11,1906,1238,668,662,72,573,1,14,1,1,6,1349,1062,287,482012226001,15000US482012226001,482012226001,19052
178,178,48,201,222600,2,2231,778,2231,2156,75,73,31,29,1,12,0,0,2,1399,1340,59,57,22,26,1,8,0,0,2,778,645,133,482012226002,15000US482012226002,482012226002,27644
179,179,48,201,222700,1,1143,532,1143,239,904,902,56,843,0,3,0,0,2,703,126,577,575,49,523,0,3,0,0,2,532,432,100,482012227001,15000US482012227001,482012227001,25000
180,180,48,201,222700,2,34,11,34,21,13,12,7,5,0,0,0,0,1,23,10,13,12,7,5,0,0,0,0,1,11,11,0,482012227002,15000US482012227002,482012227002,6230
181,181,48,201,222900,1,0,0,0,0,0,0,0,0,0,0,0,0,0,0,0,0,0,0,0,0,0,0,0,0,0,0,0,482012229001,15000US482012229001,482012229001,31190
182,182,48,201,222900,2,0,0,0,0,0,0,0,0,0,0,0,0,0,0,0,0,0,0,0,0,0,0,0,0,0,0,0,482012229002,15000US482012229002,482012229002,47275
183,183,48,201,222900,4,0,0,0,0,0,0,0,0,0,0,0,0,0,0,0,0,0,0,0,0,0,0,0,0,0,0,0,482012229004,15000US482012229004,482012229004,47692
184,184,48,201,223100,1,0,0,0,0,0,0,0,0,0,0,0,0,0,0,0,0,0,0,0,0,0,0,0,0,0,0,0,482012231001,15000US482012231001,482012231001,38864
185,185,48,201,230100,1,1705,688,1705,311,1394,1384,19,1363,1,0,0,1,10,1155,182,973,963,18,943,1,0,0,1,10,688,597,91,482012301001,15000US482012301001,482012301001,28581
186,186,48,201,230200,1,697,370,697,69,628,621,35,585,1,0,0,0,7,595,48,547,542,35,507,0,0,0,0,5,370,294,76,482012302001,15000US482012302001,482012302001,22813
187,187,48,201,230200,2,614,278,614,103,511,511,5,504,0,2,0,0,0,459,51,408,408,4,402,0,2,0,0,0,278,222,56,482012302002,15000US482012302002,482012302002,33278
188,188,48,201,230200,3,1605,611,1605,151,1454,1438,18,1416,1,1,0,2,16,1081,75,1006,994,10,980,1,1,0,2,12,611,536,75,482012302003,15000US482012302003,482012302003,25643
189,189,48,201,230200,4,1346,562,1346,238,1108,1094,46,1029,1,7,0,11,14,1039,155,884,877,35,827,1,7,0,7,7,562,498,64,482012302004,15000US482012302004,482012302004,35625
190,190,48,201,230200,5,792,303,792,77,715,710,8,701,1,0,0,0,5,600,54,546,541,7,533,1,0,0,0,5,303,288,15,482012302005,15000US482012302005,482012302005,44178
191,191,48,201,230300,1,1185,565,1185,320,865,858,22,834,1,0,0,1,7,889,181,708,701,19,681,0,0,0,1,7,565,440,125,482012303001,15000US482012303001,482012303001,25743
192,192,48,201,230300,2,618,311,618,98,520,511,6,505,0,0,0,0,9,437,46,391,385,5,380,0,0,0,0,6,311,238,73,482012303002,15000US482012303002,482012303002,16985
193,193,48,201,230400,1,843,344,843,289,554,551,8,542,0,0,1,0,3,631,181,450,447,8,438,0,0,1,0,3,344,286,58,482012304001,15000US482012304001,482012304001,22917
194,194,48,201,230400,2,1482,603,1482,616,866,855,18,833,2,2,0,0,11,1037,361,676,669,14,651,2,2,0,0,7,603,511,92,482012304002,15000US482012304002,482012304002,24507
195,195,48,201,230400,3,1394,577,1394,867,527,523,26,494,2,0,0,1,4,991,557,434,430,23,404,2,0,0,1,4,577,454,123,482012304003,15000US482012304003,482012304003,29167
196,196,48,201,230500,1,1261,350,1261,1110,151,149,58,84,0,3,0,4,2,843,724,119,118,50,65,0,3,0,0,1,350,322,28,482012305001,15000US482012305001,482012305001,42875
197,197,48,201,230500,2,1359,387,1359,1176,183,173,64,102,0,6,0,1,10,913,768,145,140,53,81,0,6,0,0,5,387,353,34,482012305002,15000US482012305002,482012305002,38563
198,198,48,201,230500,3,1554,508,1554,1026,528,521,23,492,3,1,1,1,7,1115,674,441,436,22,410,2,1,1,0,5,508,456,52,482012305003,15000US482012305003,482012305003,26366
199,199,48,201,230600,1,1126,425,1126,404,722,720,14,704,1,1,0,0,2,800,248,552,552,13,537,1,1,0,0,0,425,373,52,482012306001,15000US482012306001,482012306001,32279
200,200,48,201,230600,2,1446,597,1446,477,969,954,23,920,4,6,0,1,15,1099,308,791,783,20,752,4,6,0,1,8,597,487,110,482012306002,15000US482012306002,482012306002,20035
201,201,48,201,230700,1,828,273,828,435,393,384,25,357,1,0,1,0,9,571,259,312,304,25,277,1,0,1,0,8,273,248,25,482012307001,15000US482012307001,482012307001,21711
202,202,48,201,230700,2,1464,577,1464,180,1284,1273,7,1262,0,0,0,4,11,1000,107,893,886,5,880,0,0,0,1,7,577,501,76,482012307002,15000US482012307002,482012307002,25764
203,203,48,201,230700,3,359,295,359,15,344,344,2,341,1,0,0,0,0,268,9,259,259,2,256,1,0,0,0,0,295,164,131,482012307003,15000US482012307003,482012307003,12390
204,204,48,201,230800,1,1371,494,1371,319,1052,1050,14,1036,0,0,0,0,2,1006,191,815,813,14,799,0,0,0,0,2,494,435,59,482012308001,15000US482012308001,482012308001,29886
205,205,48,201,230800,2,1434,518,1434,318,1116,1111,30,1072,1,1,0,7,5,1099,194,905,903,24,871,1,1,0,6,2,518,475,43,482012308002,15000US482012308002,482012308002,21923
206,206,48,201,230900,1,1084,454,1084,243,841,833,40,790,3,0,0,0,8,829,151,678,674,40,632,2,0,0,0,4,454,391,63,482012309001,15000US482012309001,482012309001,15938
207,207,48,201,230900,2,888,423,888,107,781,778,13,763,2,0,0,0,3,696,72,624,622,13,607,2,0,0,0,2,423,345,78,482012309002,15000US482012309002,482012309002,29875
208,208,48,201,230900,3,1020,378,1020,291,729,715,9,704,1,0,0,1,14,738,171,567,561,5,554,1,0,0,1,6,378,340,38,482012309003,15000US482012309003,482012309003,42560
209,209,48,201,230900,4,1239,462,1239,123,1116,1106,10,1096,0,0,0,0,10,740,67,673,669,8,661,0,0,0,0,4,462,420,42,482012309004,15000US482012309004,482012309004,9682
210,210,48,201,231000,1,2262,784,2262,734,1528,1506,60,1431,9,5,0,1,22,1642,462,1180,1165,59,1096,5,4,0,1,15,784,700,84,482012310001,15000US482012310001,482012310001,26875
211,211,48,201,231000,2,2020,715,2020,742,1278,1267,70,1190,2,3,0,2,11,1461,451,1010,1003,58,938,2,3,0,2,7,715,635,80,482012310002,15000US482012310002,482012310002,26667
212,212,48,201,231100,1,1682,548,1682,901,781,777,130,634,5,3,2,3,4,1171,576,595,593,109,472,4,3,2,3,2,548,490,58,482012311001,15000US482012311001,482012311001,26729
213,213,48,201,231100,2,1466,443,1466,887,579,575,65,502,4,0,0,4,4,978,544,434,432,62,362,4,0,0,4,2,443,398,45,482012311002,15000US482012311002,482012311002,34917
214,214,48,201,231100,3,1581,454,1581,971,610,601,100,496,1,3,0,1,9,1060,615,445,442,90,347,1,3,0,1,3,454,402,52,482012311003,15000US482012311003,482012311003,31040
215,215,48,201,231200,1,3466,1030,3466,1242,2224,2213,81,2120,7,5,0,0,11,2120,728,1392,1389,63,1317,7,2,0,0,3,1030,955,75,482012312001,15000US482012312001,482012312001,35546
216,216,48,201,231200,2,1618,612,1618,225,1393,1380,41,1330,3,3,0,3,13,1176,139,1037,1030,40,983,2,3,0,2,7,612,552,60,482012312002,15000US482012312002,482012312002,48125
217,217,48,201,231200,3,1609,585,1609,321,1288,1283,24,1257,2,0,0,0,5,1002,189,813,813,18,794,1,0,0,0,0,585,528,57,482012312003,15000US482012312003,482012312003,23090
218,218,48,201,231300,1,1793,649,1793,549,1244,1240,70,1159,5,0,1,5,4,1202,309,893,891,65,819,2,0,1,4,2,649,546,103,482012313001,15000US482012313001,482012313001,35871
219,219,48,201,231300,2,2461,979,2461,288,2173,2152,27,2123,0,1,0,1,21,1838,192,1646,1634,26,1606,0,1,0,1,12,979,864,115,482012313002,15000US482012313002,482012313002,33879
220,220,48,201,231400,1,2379,958,2379,108,2271,2255,18,2231,2,2,0,2,16,1921,60,1861,1849,15,1829,1,2,0,2,12,958,905,53,482012314001,15000US482012314001,482012314001,31187
221,221,48,201,231500,1,1553,595,1553,90,1463,1458,13,1439,0,4,0,2,5,1222,58,1164,1160,8,1149,0,2,0,1,4,595,549,46,482012315001,15000US482012315001,482012315001,25673
222,222,48,201,231500,2,1153,480,1153,112,1041,1036,7,1027,1,0,0,1,5,841,66,775,771,6,763,1,0,0,1,4,480,400,80,482012315002,15000US482012315002,482012315002,23264
223,223,48,201,231600,1,1230,458,1230,290,940,938,17,916,2,3,0,0,2,912,177,735,733,16,714,0,3,0,0,2,458,415,43,482012316001,15000US482012316001,482012316001,42904
224,224,48,201,231600,2,1592,629,1592,182,1410,1394,26,1360,7,0,0,1,16,1267,112,1155,1147,23,1116,7,0,0,1,8,629,583,46,482012316002,15000US482012316002,482012316002,32160
225,225,48,201,231700,2,113,33,113,71,42,42,17,25,0,0,0,0,0,71,39,32,32,16,16,0,0,0,0,0,33,32,1,482012317002,15000US482012317002,482012317002,29102
226,226,48,201,231800,1,996,353,996,310,686,683,6,674,1,2,0,0,3,750,186,564,562,6,553,1,2,0,0,2,353,337,16,482012318001,15000US482012318001,482012318001,33265
227,227,48,201,231800,2,1768,536,1768,1268,500,495,91,395,5,4,0,0,5,1213,803,410,405,80,319,3,3,0,0,5,536,498,38,482012318002,15000US482012318002,482012318002,33734
228,228,48,201,231900,1,1749,653,1749,275,1474,1465,56,1384,14,10,0,1,9,1371,174,1197,1190,44,1127,8,10,0,1,7,653,615,38,482012319001,15000US482012319001,482012319001,42273
229,229,48,201,231900,2,1334,484,1334,150,1184,1180,9,1166,1,0,0,4,4,1024,88,936,933,9,922,0,0,0,2,3,484,455,29,482012319002,15000US482012319002,482012319002,42957
230,230,48,201,231900,3,1083,418,1083,165,918,917,13,902,0,2,0,0,1,840,105,735,735,11,722,0,2,0,0,0,418,393,25,482012319003,15000US482012319003,482012319003,42917
231,231,48,201,231900,4,1061,351,1061,316,745,740,30,708,0,1,0,1,5,749,186,563,560,26,532,0,1,0,1,3,351,329,22,482012319004,15000US482012319004,482012319004,49412
232,232,48,201,232000,1,1638,604,1638,175,1463,1458,9,1445,0,2,0,2,5,1311,102,1209,1206,9,1195,0,2,0,0,3,604,577,27,482012320001,15000US482012320001,482012320001,55114
233,233,48,201,232000,2,79,21,79,71,8,8,5,3,0,0,0,0,0,50,44,6,6,4,2,0,0,0,0,0,21,20,1,482012320002,15000US482012320002,482012320002,43611
234,234,48,201,232200,1,1110,349,1110,557,553,538,504,20,8,4,0,2,15,756,328,428,424,400,13,6,4,0,1,4,349,335,14,482012322001,15000US482012322001,482012322001,67524
235,235,48,201,232200,3,71,25,71,34,37,37,30,0,0,7,0,0,0,49,21,28,28,25,0,0,3,0,0,0,25,24,1,482012322003,15000US482012322003,482012322003,104125
236,236,48,201,232200,4,531,211,531,363,168,163,104,51,0,8,0,0,5,349,217,132,128,87,33,0,8,0,0,4,211,156,55,482012322004,15000US482012322004,482012322004,21050
237,237,48,201,232301,3,0,0,0,0,0,0,0,0,0,0,0,0,0,0,0,0,0,0,0,0,0,0,0,0,0,0,0,482012323013,15000US482012323013,482012323013,43981
238,238,48,201,232401,1,650,186,650,353,297,292,24,248,0,15,0,5,5,462,232,230,228,20,192,0,15,0,1,2,186,184,2,482012324011,15000US482012324011,482012324011,61212
239,239,48,201,232401,2,1283,359,1283,955,328,326,38,278,0,10,0,0,2,831,601,230,229,32,191,0,6,0,0,1,359,344,15,482012324012,15000US482012324012,482012324012,50227
240,240,48,201,232402,1,0,0,0,0,0,0,0,0,0,0,0,0,0,0,0,0,0,0,0,0,0,0,0,0,0,0,0,482012324021,15000US482012324021,482012324021,53542
241,241,48,201,232403,1,600,334,600,457,143,136,25,110,0,1,0,0,7,364,272,92,90,22,67,0,1,0,0,2,334,180,154,482012324031,15000US482012324031,482012324031,27358
242,242,48,201,232500,1,3135,865,3135,2109,1026,1014,407,582,9,11,0,5,12,2300,1464,836,830,373,440,6,8,0,3,6,865,797,68,482012325001,15000US482012325001,482012325001,35625
243,243,48,201,232600,1,1330,418,1330,1057,273,264,227,31,1,3,0,2,9,942,703,239,232,202,25,1,3,0,1,7,418,401,17,482012326001,15000US482012326001,482012326001,71683
244,244,48,201,232600,2,1670,495,1670,1251,419,411,205,194,2,0,0,10,8,1195,850,345,337,178,153,2,0,0,4,8,495,483,12,482012326002,15000US482012326002,482012326002,63229
245,245,48,201,232701,1,2727,1003,2727,1493,1234,1205,152,1031,2,19,0,1,29,1892,963,929,908,136,753,1,17,0,1,21,1003,796,207,482012327011,15000US482012327011,482012327011,34183
246,246,48,201,232701,2,480,173,480,201,279,277,23,244,0,10,0,0,2,327,135,192,192,18,164,0,10,0,0,0,173,151,22,482012327012,15000US482012327012,482012327012,47054
247,247,48,201,232701,3,4028,1413,4028,3152,876,853,129,696,5,18,0,5,23,2535,1954,581,575,97,452,4,18,0,4,6,1413,1199,214,482012327013,15000US482012327013,482012327013,30179
248,248,48,201,232702,1,2535,1146,2535,2250,285,277,68,175,13,21,0,0,8,1747,1544,203,199,54,120,6,19,0,0,4,1146,750,396,482012327021,15000US482012327021,482012327021,30128
249,249,48,201,232702,2,225,89,225,134,91,91,3,85,2,1,0,0,0,169,90,79,79,3,73,2,1,0,0,0,89,72,17,482012327022,15000US482012327022,482012327022,51750
250,250,48,201,232702,3,2457,931,2457,1211,1246,1222,499,689,9,16,0,9,24,1723,772,951,933,448,459,8,11,0,7,18,931,875,56,482012327023,15000US482012327023,482012327023,37616
251,251,48,201,232800,1,9,2,9,0,9,9,0,9,0,0,0,0,0,7,0,7,7,0,7,0,0,0,0,0,2,2,0,482012328001,15000US482012328001,482012328001,35346
252,252,48,201,232800,2,5,3,5,1,4,4,0,3,0,1,0,0,0,5,1,4,4,0,3,0,1,0,0,0,3,3,0,482012328002,15000US482012328002,482012328002,46642
253,253,48,201,232900,1,0,0,0,0,0,0,0,0,0,0,0,0,0,0,0,0,0,0,0,0,0,0,0,0,0,0,0,482012329001,15000US482012329001,482012329001,59915
254,254,48,201,232900,2,4,1,4,0,4,3,0,0,0,3,0,0,1,3,0,3,2,0,0,0,2,0,0,1,1,1,0,482012329002,15000US482012329002,482012329002,49296
255,255,48,201,232900,3,925,456,925,325,600,589,51,509,0,29,0,0,11,602,196,406,401,37,339,0,25,0,0,5,456,369,87,482012329003,15000US482012329003,482012329003,46821
256,256,48,201,233001,1,41,23,41,9,32,31,14,17,0,0,0,0,1,28,3,25,25,13,12,0,0,0,0,0,23,15,8,482012330011,15000US482012330011,482012330011,51799
257,257,48,201,233001,2,1734,1001,1734,825,909,902,149,737,4,7,0,5,7,1108,502,606,602,124,462,4,7,0,5,4,1001,596,405,482012330012,15000US482012330012,482012330012,40972
258,258,48,201,233003,1,0,0,0,0,0,0,0,0,0,0,0,0,0,0,0,0,0,0,0,0,0,0,0,0,0,0,0,482012330031,15000US482012330031,482012330031,61027
259,259,48,201,233003,2,2,1,2,0,2,0,0,0,0,0,0,0,2,2,0,2,0,0,0,0,0,0,0,2,1,1,0,482012330032,15000US482012330032,482012330032,80714
260,260,48,201,233101,2,271,82,271,211,60,59,49,4,1,5,0,0,1,182,133,49,48,39,3,1,5,0,0,1,82,76,6,482012331012,15000US482012331012,482012331012,46113
261,261,48,201,233101,3,0,0,0,0,0,0,0,0,0,0,0,0,0,0,0,0,0,0,0,0,0,0,0,0,0,0,0,482012331013,15000US482012331013,482012331013,41410
262,262,48,201,233102,1,6,3,6,4,2,2,1,1,0,0,0,0,0,5,4,1,1,1,0,0,0,0,0,0,3,2,1,482012331021,15000US482012331021,482012331021,24338
263,263,48,201,233102,2,0,0,0,0,0,0,0,0,0,0,0,0,0,0,0,0,0,0,0,0,0,0,0,0,0,0,0,482012331022,15000US482012331022,482012331022,33859
264,264,48,201,233102,3,12,6,12,12,0,0,0,0,0,0,0,0,0,9,9,0,0,0,0,0,0,0,0,0,6,5,1,482012331023,15000US482012331023,482012331023,27467
265,265,48,201,233103,1,20,8,20,18,2,2,0,2,0,0,0,0,0,15,14,1,1,0,1,0,0,0,0,0,8,8,0,482012331031,15000US482012331031,482012331031,27650
266,266,48,201,233103,2,219,61,219,171,48,47,38,6,2,0,0,1,1,154,116,38,37,31,4,2,0,0,0,1,61,56,5,482012331032,15000US482012331032,482012331032,28835
267,267,48,201,233200,1,1493,473,1493,931,562,558,481,72,3,2,0,0,4,1021,567,454,452,409,40,1,2,0,0,2,473,450,23,482012332001,15000US482012332001,482012332001,54712
268,268,48,201,233200,2,1675,504,1675,1147,528,522,476,42,2,2,0,0,6,1107,672,435,431,400,27,2,2,0,0,4,504,476,28,482012332002,15000US482012332002,482012332002,29457
269,269,48,201,233200,3,1509,454,1509,1173,336,329,284,35,2,3,2,3,7,1015,730,285,282,244,31,2,3,2,0,3,454,419,35,482012332003,15000US482012332003,482012332003,47750
270,270,48,201,233200,4,1555,449,1555,1193,362,360,310,34,1,13,0,2,2,1020,726,294,292,260,18,1,11,0,2,2,449,419,30,482012332004,15000US482012332004,482012332004,45319
271,271,48,201,233300,1,1047,306,1047,980,67,66,56,5,5,0,0,0,1,674,614,60,60,50,5,5,0,0,0,0,306,264,42,482012333001,15000US482012333001,482012333001,33190
272,272,48,201,233300,2,2151,583,2151,1879,272,269,241,15,10,2,0,1,3,1393,1154,239,238,220,11,5,2,0,0,1,583,551,32,482012333002,15000US482012333002,482012333002,41165
273,273,48,201,233300,3,1620,440,1620,1462,158,157,134,15,0,6,0,2,1,1080,946,134,133,112,15,0,5,0,1,1,440,413,27,482012333003,15000US482012333003,482012333003,39100
274,274,48,201,233400,1,0,0,0,0,0,0,0,0,0,0,0,0,0,0,0,0,0,0,0,0,0,0,0,0,0,0,0,482012334001,15000US482012334001,482012334001,44223
275,275,48,201,233400,2,0,0,0,0,0,0,0,0,0,0,0,0,0,0,0,0,0,0,0,0,0,0,0,0,0,0,0,482012334002,15000US482012334002,482012334002,36528
276,276,48,201,233500,3,0,0,0,0,0,0,0,0,0,0,0,0,0,0,0,0,0,0,0,0,0,0,0,0,0,0,0,482012335003,15000US482012335003,482012335003,46349
277,277,48,201,233600,1,1059,463,1059,249,810,804,5,795,1,2,0,1,6,786,140,646,640,5,631,1,2,0,1,6,463,394,69,482012336001,15000US482012336001,482012336001,20542
278,278,48,201,233600,2,1068,477,1068,277,791,788,5,776,4,3,0,0,3,778,153,625,622,5,612,2,3,0,0,3,477,382,95,482012336002,15000US482012336002,482012336002,34148
279,279,48,201,233701,1,14,12,14,12,2,2,0,2,0,0,0,0,0,11,9,2,2,0,2,0,0,0,0,0,12,6,6,482012337011,15000US482012337011,482012337011,39137
280,280,48,201,233703,1,0,0,0,0,0,0,0,0,0,0,0,0,0,0,0,0,0,0,0,0,0,0,0,0,0,0,0,482012337031,15000US482012337031,482012337031,29444
281,281,48,201,240100,1,1563,811,1563,991,572,560,76,456,4,18,1,5,12,1081,650,431,423,62,334,4,18,1,4,8,811,643,168,482012401001,15000US482012401001,482012401001,31163
282,282,48,201,240100,2,1504,769,1504,760,744,725,68,647,3,4,1,2,19,1051,491,560,549,62,477,3,4,1,2,11,769,633,136,482012401002,15000US482012401002,482012401002,20026
283,283,48,201,240400,1,0,0,0,0,0,0,0,0,0,0,0,0,0,0,0,0,0,0,0,0,0,0,0,0,0,0,0,482012404001,15000US482012404001,482012404001,60785
284,284,48,201,240400,2,101,31,101,71,30,28,25,3,0,0,0,0,2,61,38,23,21,18,3,0,0,0,0,2,31,29,2,482012404002,15000US482012404002,482012404002,30817
285,285,48,201,240501,1,951,674,951,172,779,769,46,709,1,2,2,9,10,713,116,597,592,40,542,1,2,2,5,5,674,488,186,482012405011,15000US482012405011,482012405011,31060
286,286,48,201,240501,2,1501,713,1501,882,619,600,31,547,2,11,0,9,19,1013,566,447,435,27,389,2,10,0,7,12,713,577,136,482012405012,15000US482012405012,482012405012,24128
287,287,48,201,240502,1,1456,770,1456,850,606,582,53,526,0,3,0,0,24,991,524,467,451,48,400,0,3,0,0,16,770,571,199,482012405021,15000US482012405021,482012405021,26431
288,288,48,201,240502,2,1895,997,1895,1027,868,861,79,766,4,7,0,5,7,1330,693,637,631,68,549,3,6,0,5,6,997,781,216,482012405022,15000US482012405022,482012405022,31033
289,289,48,201,240502,3,2243,979,2243,1251,992,981,49,922,0,9,0,1,11,1390,758,632,627,30,588,0,9,0,0,5,979,848,131,482012405023,15000US482012405023,482012405023,20638
290,290,48,201,240600,1,2327,1047,2327,1462,865,849,78,761,0,3,4,3,16,1523,924,599,592,54,530,0,3,2,3,7,1047,862,185,482012406001,15000US482012406001,482012406001,28542
291,291,48,201,240701,1,573,362,573,134,439,430,83,309,4,29,3,2,9,473,110,363,359,77,251,4,24,3,0,4,362,299,63,482012407011,15000US482012407011,482012407011,57722
292,292,48,201,240701,2,0,0,0,0,0,0,0,0,0,0,0,0,0,0,0,0,0,0,0,0,0,0,0,0,0,0,0,482012407012,15000US482012407012,482012407012,53658
293,293,48,201,240702,1,599,171,599,277,322,320,23,283,3,11,0,0,2,352,163,189,189,17,163,2,7,0,0,0,171,167,4,482012407021,15000US482012407021,482012407021,42457
294,294,48,201,240702,2,3,1,3,3,0,0,0,0,0,0,0,0,0,2,2,0,0,0,0,0,0,0,0,0,1,1,0,482012407022,15000US482012407022,482012407022,49359
295,295,48,201,240801,1,4,1,4,4,0,0,0,0,0,0,0,0,0,2,2,0,0,0,0,0,0,0,0,0,1,1,0,482012408011,15000US482012408011,482012408011,27433
296,296,48,201,240801,2,1,1,1,1,0,0,0,0,0,0,0,0,0,1,1,0,0,0,0,0,0,0,0,0,1,1,0,482012408012,15000US482012408012,482012408012,22010
297,297,48,201,240801,4,0,0,0,0,0,0,0,0,0,0,0,0,0,0,0,0,0,0,0,0,0,0,0,0,0,0,0,482012408014,15000US482012408014,482012408014,29671
298,298,48,201,240802,1,0,0,0,0,0,0,0,0,0,0,0,0,0,0,0,0,0,0,0,0,0,0,0,0,0,0,0,482012408021,15000US482012408021,482012408021,51023
299,299,48,201,240802,2,13,5,13,1,12,12,8,4,0,0,0,0,0,9,1,8,8,6,2,0,0,0,0,0,5,5,0,482012408022,15000US482012408022,482012408022,42500
300,300,48,201,240902,1,0,0,0,0,0,0,0,0,0,0,0,0,0,0,0,0,0,0,0,0,0,0,0,0,0,0,0,482012409021,15000US482012409021,482012409021,73103
301,301,48,201,240902,2,32,14,32,13,19,19,4,15,0,0,0,0,0,21,6,15,15,4,11,0,0,0,0,0,14,14,0,482012409022,15000US482012409022,482012409022,63957
302,302,48,201,241300,1,0,0,0,0,0,0,0,0,0,0,0,0,0,0,0,0,0,0,0,0,0,0,0,0,0,0,0,482012413001,15000US482012413001,482012413001,66510
303,303,48,201,241300,2,231,76,231,76,155,154,98,38,0,17,0,1,1,154,56,98,97,57,26,0,13,0,1,1,76,72,4,482012413002,15000US482012413002,482012413002,94028
304,304,48,201,241300,3,80,40,80,26,54,54,28,5,0,21,0,0,0,66,21,45,45,27,5,0,13,0,0,0,40,38,2,482012413003,15000US482012413003,482012413003,71964
305,305,48,201,241500,1,1366,662,1366,292,1074,1054,229,784,3,27,9,2,20,976,195,781,769,206,527,3,24,7,2,12,662,604,58,482012415001,15000US482012415001,482012415001,26207
306,306,48,201,241500,2,1886,595,1886,859,1027,1013,333,660,3,16,0,1,14,1254,524,730,724,273,433,3,14,0,1,6,595,569,26,482012415002,15000US482012415002,482012415002,43594
307,307,48,201,241500,3,3597,1052,3597,1303,2294,2251,589,1553,2,75,20,12,43,2562,934,1628,1602,540,976,1,69,9,7,26,1052,945,107,482012415003,15000US482012415003,482012415003,27604
308,308,48,201,241500,4,0,0,0,0,0,0,0,0,0,0,0,0,0,0,0,0,0,0,0,0,0,0,0,0,0,0,0,482012415004,15000US482012415004,482012415004,31895
309,309,48,201,250100,2,148,58,148,60,88,85,78,5,1,1,0,0,3,106,33,73,72,67,3,1,1,0,0,1,58,54,4,482012501002,15000US482012501002,482012501002,53079
310,310,48,201,250100,3,5,4,5,1,4,3,2,0,0,1,0,0,1,5,1,4,3,2,0,0,1,0,0,1,4,4,0,482012501003,15000US482012501003,482012501003,58250
311,311,48,201,250301,1,0,0,0,0,0,0,0,0,0,0,0,0,0,0,0,0,0,0,0,0,0,0,0,0,0,0,0,482012503011,15000US482012503011,482012503011,62955
312,312,48,201,250401,1,0,0,0,0,0,0,0,0,0,0,0,0,0,0,0,0,0,0,0,0,0,0,0,0,0,0,0,482012504011,15000US482012504011,482012504011,92163
313,313,48,201,250401,2,0,0,0,0,0,0,0,0,0,0,0,0,0,0,0,0,0,0,0,0,0,0,0,0,0,0,0,482012504012,15000US482012504012,482012504012,79325
314,314,48,201,250402,1,6,2,6,1,5,5,5,0,0,0,0,0,0,4,1,3,3,3,0,0,0,0,0,0,2,2,0,482012504021,15000US482012504021,482012504021,104123
315,315,48,201,250402,2,3,3,3,0,3,3,2,0,0,1,0,0,0,3,0,3,3,2,0,0,1,0,0,0,3,2,1,482012504022,15000US482012504022,482012504022,63875
316,316,48,201,250402,3,124,55,124,13,111,106,91,4,0,10,1,0,5,101,8,93,91,77,3,0,10,1,0,2,55,50,5,482012504023,15000US482012504023,482012504023,71500
317,317,48,201,250500,1,0,0,0,0,0,0,0,0,0,0,0,0,0,0,0,0,0,0,0,0,0,0,0,0,0,0,0,482012505001,15000US482012505001,482012505001,60542
318,318,48,201,250500,2,0,0,0,0,0,0,0,0,0,0,0,0,0,0,0,0,0,0,0,0,0,0,0,0,0,0,0,482012505002,15000US482012505002,482012505002,77569
319,319,48,201,250600,5,147,61,147,11,136,133,106,13,3,10,1,0,3,128,9,119,117,95,9,3,9,1,0,2,61,60,1,482012506005,15000US482012506005,482012506005,38405
320,320,48,201,250701,1,0,0,0,0,0,0,0,0,0,0,0,0,0,0,0,0,0,0,0,0,0,0,0,0,0,0,0,482012507011,15000US482012507011,482012507011,85670
321,321,48,201,250701,2,213,98,213,34,179,175,165,9,1,0,0,0,4,174,27,147,145,139,5,1,0,0,0,2,98,87,11,482012507012,15000US482012507012,482012507012,63750
322,322,48,201,250701,3,2,1,2,1,1,1,1,0,0,0,0,0,0,2,1,1,1,1,0,0,0,0,0,0,1,1,0,482012507013,15000US482012507013,482012507013,61691
323,323,48,201,250702,1,52,16,52,11,41,39,39,0,0,0,0,0,2,39,8,31,30,30,0,0,0,0,0,1,16,16,0,482012507021,15000US482012507021,482012507021,93598
324,324,48,201,250702,2,36,10,36,0,36,34,23,0,0,11,0,0,2,25,0,25,24,15,0,0,9,0,0,1,10,10,0,482012507022,15000US482012507022,482012507022,100230
325,325,48,201,250800,1,4,1,4,0,4,4,3,1,0,0,0,0,0,4,0,4,4,3,1,0,0,0,0,0,1,1,0,482012508001,15000US482012508001,482012508001,128375
326,326,48,201,250800,2,93,44,93,3,90,90,84,0,0,6,0,0,0,77,1,76,76,70,0,0,6,0,0,0,44,41,3,482012508002,15000US482012508002,482012508002,76957
327,327,48,201,250800,3,242,84,242,37,205,204,194,5,1,4,0,0,1,180,22,158,157,148,5,1,3,0,0,1,84,81,3,482012508003,15000US482012508003,482012508003,123365
328,328,48,201,250900,1,1400,455,1400,80,1320,1301,1242,19,1,30,0,9,19,974,47,927,918,871,14,0,27,0,6,9,455,450,5,482012509001,15000US482012509001,482012509001,141641
329,329,48,201,250900,2,2763,1667,2763,208,2555,2531,2364,97,9,53,1,7,24,2256,142,2114,2100,1963,76,7,46,1,7,14,1667,1318,349,482012509002,15000US482012509002,482012509002,104120
330,330,48,201,250900,3,1151,357,1151,88,1063,1050,995,12,3,40,0,0,13,762,54,708,707,671,9,1,26,0,0,1,357,347,10,482012509003,15000US482012509003,482012509003,172396
331,331,48,201,250900,4,3255,1080,3255,220,3035,3010,2858,53,11,82,1,5,25,2246,123,2123,2112,2009,36,8,55,1,3,11,1080,1044,36,482012509004,15000US482012509004,482012509004,214250
332,332,48,201,251000,1,1993,1125,1993,273,1720,1677,1411,138,5,110,3,10,43,1595,199,1396,1370,1179,97,5,79,3,7,26,1125,1011,114,482012510001,15000US482012510001,482012510001,60384
333,333,48,201,251000,2,781,353,781,54,727,719,685,12,2,20,0,0,8,658,40,618,610,588,9,0,13,0,0,8,353,330,23,482012510002,15000US482012510002,482012510002,124000
334,334,48,201,251100,1,1365,547,1365,136,1229,1218,1156,35,2,20,3,2,11,1075,90,985,977,934,25,2,14,1,1,8,547,529,18,482012511001,15000US482012511001,482012511001,82339
335,335,48,201,251100,2,1216,493,1216,176,1040,1031,938,67,5,14,7,0,9,916,106,810,806,744,44,5,9,4,0,4,493,462,31,482012511002,15000US482012511002,482012511002,104922
336,336,48,201,251100,3,2110,811,2110,263,1847,1820,1674,45,16,83,0,2,27,1669,166,1503,1482,1363,34,15,70,0,0,21,811,784,27,482012511003,15000US482012511003,482012511003,116464
337,337,48,201,251100,4,630,271,630,73,557,549,502,31,1,13,2,0,8,480,46,434,429,398,19,1,10,1,0,5,271,247,24,482012511004,15000US482012511004,482012511004,73365
338,338,48,201,251100,5,2079,845,2079,447,1632,1599,1402,133,15,36,10,3,33,1572,270,1302,1291,1150,93,12,29,5,2,11,845,792,53,482012511005,15000US482012511005,482012511005,56691
339,339,48,201,251200,1,1776,729,1776,249,1527,1503,1377,73,0,48,0,5,24,1301,163,1138,1126,1038,54,0,29,0,5,12,729,639,90,482012512001,15000US482012512001,482012512001,75117
340,340,48,201,251200,2,2438,967,2438,361,2077,2042,1919,81,3,38,1,0,35,1787,231,1556,1540,1451,56,3,29,1,0,16,967,883,84,482012512002,15000US482012512002,482012512002,88333
341,341,48,201,251200,3,491,184,491,62,429,423,399,9,0,10,3,2,6,375,37,338,335,315,8,0,8,2,2,3,184,176,8,482012512003,15000US482012512003,482012512003,80363
342,342,48,201,251300,1,1694,633,1694,308,1386,1355,1278,48,5,20,0,4,31,1202,165,1037,1022,968,32,5,14,0,3,15,633,603,30,482012513001,15000US482012513001,482012513001,57619
343,343,48,201,251300,2,1853,618,1853,197,1656,1640,1559,48,1,27,0,5,16,1337,129,1208,1200,1142,34,0,20,0,4,8,618,608,10,482012513002,15000US482012513002,482012513002,126410
344,344,48,201,251300,3,959,342,959,76,883,871,831,11,2,22,0,5,12,710,47,663,657,623,10,2,20,0,2,6,342,333,9,482012513003,15000US482012513003,482012513003,130329
345,345,48,201,251300,4,1609,624,1609,118,1491,1470,1441,20,1,8,0,0,21,1267,78,1189,1180,1153,18,1,8,0,0,9,624,603,21,482012513004,15000US482012513004,482012513004,123250
346,346,48,201,251300,5,1044,448,1044,74,970,946,916,12,7,11,0,0,24,813,54,759,748,725,9,7,7,0,0,11,448,429,19,482012513005,15000US482012513005,482012513005,91587
347,347,48,201,251401,1,2446,834,2446,385,2061,2034,1864,80,10,78,0,2,27,1661,229,1432,1421,1304,53,5,59,0,0,11,834,809,25,482012514011,15000US482012514011,482012514011,106806
348,348,48,201,251402,1,2706,1035,2706,468,2238,2207,2081,75,3,41,0,7,31,1927,295,1632,1615,1516,56,3,36,0,4,17,1035,1006,29,482012514021,15000US482012514021,482012514021,58608
349,349,48,201,251402,2,1741,636,1741,234,1507,1482,1397,43,6,34,2,0,25,1262,152,1110,1098,1028,35,4,29,2,0,12,636,611,25,482012514022,15000US482012514022,482012514022,75885
350,350,48,201,251402,3,1477,687,1477,241,1236,1226,1141,49,4,28,0,4,10,1106,157,949,942,874,37,4,23,0,4,7,687,644,43,482012514023,15000US482012514023,482012514023,63523
351,351,48,201,251501,1,4759,1489,4759,550,4209,4121,3615,128,18,351,4,5,88,2993,315,2678,2643,2306,85,12,233,4,3,35,1489,1423,66,482012515011,15000US482012515011,482012515011,118237
352,352,48,201,251502,1,1590,543,1590,121,1469,1455,1412,10,4,19,9,1,14,1153,75,1078,1069,1037,9,4,14,4,1,9,543,529,14,482012515021,15000US482012515021,482012515021,129219
353,353,48,201,251502,2,1478,548,1478,133,1345,1326,1253,12,5,48,2,6,19,1128,100,1028,1020,964,11,4,36,0,5,8,548,535,13,482012515022,15000US482012515022,482012515022,103533
354,354,48,201,251502,3,1417,458,1417,95,1322,1292,1184,39,8,56,2,3,30,1008,59,949,928,847,27,6,45,2,1,21,458,448,10,482012515023,15000US482012515023,482012515023,142750
355,355,48,201,251502,4,2220,787,2220,207,2013,1987,1833,74,1,71,0,8,26,1609,131,1478,1464,1351,49,1,60,0,3,14,787,759,28,482012515024,15000US482012515024,482012515024,133611
356,356,48,201,251502,5,1227,563,1227,85,1142,1130,1090,22,1,15,1,1,12,1005,57,948,944,916,12,1,13,1,1,4,563,540,23,482012515025,15000US482012515025,482012515025,89044
357,357,48,201,251502,6,1487,734,1487,205,1282,1259,1138,64,2,43,1,11,23,1162,148,1014,1003,903,56,2,33,1,8,11,734,630,104,482012515026,15000US482012515026,482012515026,85000
358,358,48,201,251503,1,2264,798,2264,269,1995,1958,1827,39,6,78,3,5,37,1549,161,1388,1375,1271,30,3,67,2,2,13,798,773,25,482012515031,15000US482012515031,482012515031,87366
359,359,48,201,251600,1,39,12,39,5,34,34,34,0,0,0,0,0,0,27,2,25,25,25,0,0,0,0,0,0,12,10,2,482012516001,15000US482012516001,482012516001,54333
360,360,48,201,251600,2,354,174,354,18,336,333,318,5,7,0,0,3,3,300,14,286,284,271,5,5,0,0,3,2,174,150,24,482012516002,15000US482012516002,482012516002,95880
361,361,48,201,251700,1,70,37,70,6,64,62,58,4,0,0,0,0,2,59,4,55,53,50,3,0,0,0,0,2,37,31,6,482012517001,15000US482012517001,482012517001,61607
362,362,48,201,251700,2,2895,1040,2895,384,2511,2476,2405,36,11,22,2,0,35,1971,212,1759,1744,1698,23,6,15,2,0,15,1040,974,66,482012517002,15000US482012517002,482012517002,55519
363,363,48,201,251700,3,130,50,130,20,110,110,109,1,0,0,0,0,0,97,12,85,85,84,1,0,0,0,0,0,50,46,4,482012517003,15000US482012517003,482012517003,60030
364,364,48,201,251700,4,1027,440,1027,116,911,898,768,91,10,12,1,16,13,739,84,655,650,558,58,10,11,1,12,5,440,376,64,482012517004,15000US482012517004,482012517004,79625
365,365,48,201,251901,2,122,51,122,6,116,116,109,0,0,7,0,0,0,91,3,88,88,82,0,0,6,0,0,0,51,43,8,482012519012,15000US482012519012,482012519012,37000
366,366,48,201,251901,3,0,0,0,0,0,0,0,0,0,0,0,0,0,0,0,0,0,0,0,0,0,0,0,0,0,0,0,482012519013,15000US482012519013,482012519013,62418
367,367,48,201,251901,4,0,0,0,0,0,0,0,0,0,0,0,0,0,0,0,0,0,0,0,0,0,0,0,0,0,0,0,482012519014,15000US482012519014,482012519014,53681
368,368,48,201,251902,1,0,0,0,0,0,0,0,0,0,0,0,0,0,0,0,0,0,0,0,0,0,0,0,0,0,0,0,482012519021,15000US482012519021,482012519021,75208
369,369,48,201,251902,2,0,0,0,0,0,0,0,0,0,0,0,0,0,0,0,0,0,0,0,0,0,0,0,0,0,0,0,482012519022,15000US482012519022,482012519022,90536
370,370,48,201,252000,1,9385,3234,9385,1967,7418,7227,4810,1915,13,463,5,21,191,6435,1199,5236,5135,3438,1320,9,353,4,11,101,3234,3085,149,482012520001,15000US482012520001,482012520001,106250
371,371,48,201,252100,1,5,5,5,0,5,5,5,0,0,0,0,0,0,5,0,5,5,5,0,0,0,0,0,0,5,4,1,482012521001,15000US482012521001,482012521001,52059
372,372,48,201,252200,2,383,200,383,147,236,226,38,170,3,15,0,0,10,273,102,171,163,33,116,3,11,0,0,8,200,178,22,482012522002,15000US482012522002,482012522002,54281
373,373,48,201,252400,2,0,0,0,0,0,0,0,0,0,0,0,0,0,0,0,0,0,0,0,0,0,0,0,0,0,0,0,482012524002,15000US482012524002,482012524002,64167
374,374,48,201,252400,3,0,0,0,0,0,0,0,0,0,0,0,0,0,0,0,0,0,0,0,0,0,0,0,0,0,0,0,482012524003,15000US482012524003,482012524003,31138
375,375,48,201,252500,1,169,68,169,121,48,44,43,1,0,0,0,0,4,121,78,43,41,40,1,0,0,0,0,2,68,58,10,482012525001,15000US482012525001,482012525001,45795
376,376,48,201,252500,2,0,0,0,0,0,0,0,0,0,0,0,0,0,0,0,0,0,0,0,0,0,0,0,0,0,0,0,482012525002,15000US482012525002,482012525002,31149
377,377,48,201,252600,4,0,0,0,0,0,0,0,0,0,0,0,0,0,0,0,0,0,0,0,0,0,0,0,0,0,0,0,482012526004,15000US482012526004,482012526004,39350
378,378,48,201,253300,2,0,0,0,0,0,0,0,0,0,0,0,0,0,0,0,0,0,0,0,0,0,0,0,0,0,0,0,482012533002,15000US482012533002,482012533002,62781
379,379,48,201,254500,2,0,0,0,0,0,0,0,0,0,0,0,0,0,0,0,0,0,0,0,0,0,0,0,0,0,0,0,482012545002,15000US482012545002,482012545002,35302
380,380,48,201,254600,2,0,0,0,0,0,0,0,0,0,0,0,0,0,0,0,0,0,0,0,0,0,0,0,0,0,0,0,482012546002,15000US482012546002,482012546002,49904
381,381,48,201,310100,1,3029,1272,3029,1144,1885,1839,483,1306,5,43,0,2,46,2146,797,1349,1318,457,813,5,41,0,2,31,1272,1148,124,482013101001,15000US482013101001,482013101001,26497
382,382,48,201,310100,2,2855,1243,2855,1473,1382,1356,793,479,8,76,0,0,26,2363,1124,1239,1214,743,392,8,71,0,0,25,1243,1056,187,482013101002,15000US482013101002,482013101002,43750
383,383,48,201,310200,1,1463,883,1463,331,1132,1099,535,427,0,133,0,4,33,1299,280,1019,994,522,350,0,119,0,3,25,883,738,145,482013102001,15000US482013102001,482013102001,62778
384,384,48,201,310300,1,882,393,882,647,235,230,199,19,5,4,2,1,5,701,494,207,204,177,18,3,3,2,1,3,393,339,54,482013103001,15000US482013103001,482013103001,45500
385,385,48,201,310300,2,743,356,743,565,178,165,110,28,2,20,0,5,13,581,418,163,153,105,23,2,18,0,5,10,356,294,62,482013103002,15000US482013103002,482013103002,37200
386,386,48,201,310300,3,758,451,758,649,109,104,57,32,0,15,0,0,5,563,469,94,89,47,28,0,14,0,0,5,451,253,198,482013103003,15000US482013103003,482013103003,29313
387,387,48,201,310300,4,1071,568,1071,631,440,422,274,72,7,68,0,1,18,891,492,399,387,263,59,4,60,0,1,12,568,478,90,482013103004,15000US482013103004,482013103004,45682
388,388,48,201,310300,5,712,291,712,570,142,135,105,9,2,18,0,1,7,534,416,118,112,90,5,2,15,0,0,6,291,241,50,482013103005,15000US482013103005,482013103005,27288
389,389,48,201,310300,6,608,241,608,504,104,99,40,47,4,7,0,1,5,457,367,90,85,37,38,3,7,0,0,5,241,199,42,482013103006,15000US482013103006,482013103006,47254
390,390,48,201,310400,1,1663,558,1663,1571,92,90,76,5,1,2,0,6,2,1199,1126,73,71,60,5,1,2,0,3,2,558,493,65,482013104001,15000US482013104001,482013104001,32644
391,391,48,201,310400,2,948,364,948,884,64,63,33,25,4,1,0,0,1,694,634,60,59,30,24,4,1,0,0,1,364,290,74,482013104002,15000US482013104002,482013104002,15793
392,392,48,201,310400,3,1473,625,1473,1334,139,132,82,37,1,12,0,0,7,1103,981,122,118,69,37,1,11,0,0,4,625,536,89,482013104003,15000US482013104003,482013104003,25682
393,393,48,201,310500,1,749,296,749,699,50,48,41,7,0,0,0,0,2,508,461,47,45,38,7,0,0,0,0,2,296,244,52,482013105001,15000US482013105001,482013105001,30795
394,394,48,201,310500,2,2425,781,2425,2066,359,354,165,171,4,11,0,3,5,1729,1406,323,320,152,153,4,10,0,1,3,781,672,109,482013105002,15000US482013105002,482013105002,28668
395,395,48,201,310500,3,1682,600,1682,1631,51,48,38,5,2,1,2,0,3,1212,1173,39,38,30,5,1,1,1,0,1,600,523,77,482013105003,15000US482013105003,482013105003,17446
396,396,48,201,310600,1,1018,366,1018,912,106,103,64,25,2,12,0,0,3,738,648,90,89,61,17,2,9,0,0,1,366,322,44,482013106001,15000US482013106001,482013106001,16860
397,397,48,201,310600,2,1919,685,1919,1754,165,159,110,28,6,15,0,0,6,1394,1251,143,139,103,22,0,14,0,0,4,685,598,87,482013106002,15000US482013106002,482013106002,44102
398,398,48,201,310600,3,814,321,814,721,93,89,56,30,0,1,0,2,4,595,512,83,79,50,26,0,1,0,2,4,321,283,38,482013106003,15000US482013106003,482013106003,30029
399,399,48,201,310600,4,1014,379,1014,925,89,86,61,21,0,4,0,0,3,726,648,78,76,56,17,0,3,0,0,2,379,311,68,482013106004,15000US482013106004,482013106004,41220
400,400,48,201,310600,5,1260,477,1260,1063,197,192,136,27,0,28,0,1,5,914,735,179,174,129,21,0,24,0,0,5,477,414,63,482013106005,15000US482013106005,482013106005,21786
401,401,48,201,310700,1,1948,659,1948,1782,166,164,103,32,0,29,0,0,2,1356,1212,144,142,90,27,0,25,0,0,2,659,560,99,482013107001,15000US482013107001,482013107001,37906
402,402,48,201,310700,2,2219,839,2219,1672,547,531,476,32,6,16,0,1,16,1645,1149,496,485,435,29,4,16,0,1,11,839,749,90,482013107002,15000US482013107002,482013107002,54955
403,403,48,201,310800,1,1353,504,1353,1297,56,55,22,32,0,1,0,0,1,878,841,37,36,15,20,0,1,0,0,1,504,410,94,482013108001,15000US482013108001,482013108001,23125
404,404,48,201,310800,2,1137,520,1137,1012,125,122,110,8,0,2,0,2,3,769,656,113,112,102,6,0,2,0,2,1,520,336,184,482013108002,15000US482013108002,482013108002,30742
405,405,48,201,310900,1,838,272,838,809,29,29,16,9,0,0,1,3,0,537,519,18,18,13,4,0,0,1,0,0,272,235,37,482013109001,15000US482013109001,482013109001,29167
406,406,48,201,310900,2,1597,521,1597,1528,69,67,46,10,0,10,0,1,2,1088,1024,64,64,44,10,0,9,0,1,0,521,463,58,482013109002,15000US482013109002,482013109002,32679
407,407,48,201,310900,3,1009,488,1009,901,108,102,53,42,2,0,1,4,6,760,657,103,97,50,41,2,0,1,3,6,488,388,100,482013109003,15000US482013109003,482013109003,26777
408,408,48,201,310900,4,907,305,907,880,27,27,12,12,0,3,0,0,0,609,585,24,24,9,12,0,3,0,0,0,305,277,28,482013109004,15000US482013109004,482013109004,37604
409,409,48,201,310900,5,1419,529,1419,1374,45,44,34,5,4,1,0,0,1,1032,988,44,44,34,5,4,1,0,0,0,529,430,99,482013109005,15000US482013109005,482013109005,26304
410,410,48,201,311000,1,1078,392,1078,1059,19,19,12,4,1,1,0,1,0,749,731,18,18,12,4,1,1,0,0,0,392,318,74,482013110001,15000US482013110001,482013110001,25938
411,411,48,201,311000,2,1076,385,1076,1015,61,58,38,6,6,6,0,2,3,776,725,51,49,35,4,3,6,0,1,2,385,335,50,482013110002,15000US482013110002,482013110002,27025
412,412,48,201,311000,3,1588,523,1588,1553,35,35,29,4,0,1,0,1,0,1073,1040,33,33,28,3,0,1,0,1,0,523,468,55,482013110003,15000US482013110003,482013110003,26806
413,413,48,201,311000,4,1442,474,1442,1411,31,29,18,9,1,1,0,0,2,997,972,25,23,16,5,1,1,0,0,2,474,416,58,482013110004,15000US482013110004,482013110004,25234
414,414,48,201,311000,5,1927,700,1927,1875,52,52,36,13,0,0,0,3,0,1399,1350,49,49,34,13,0,0,0,2,0,700,589,111,482013110005,15000US482013110005,482013110005,36042
415,415,48,201,311100,1,1170,449,1170,1145,25,25,19,2,0,4,0,0,0,829,808,21,21,17,2,0,2,0,0,0,449,372,77,482013111001,15000US482013111001,482013111001,34800
416,416,48,201,311100,2,1191,385,1191,1143,48,48,40,5,2,1,0,0,0,822,783,39,39,34,4,0,1,0,0,0,385,342,43,482013111002,15000US482013111002,482013111002,40702
417,417,48,201,311100,3,1589,557,1589,1536,53,48,41,2,2,1,0,2,5,1123,1082,41,39,34,2,2,1,0,0,2,557,492,65,482013111003,15000US482013111003,482013111003,24365
418,418,48,201,311100,4,1936,687,1936,1868,68,62,28,21,3,7,0,3,6,1360,1310,50,46,21,17,2,5,0,1,4,687,589,98,482013111004,15000US482013111004,482013111004,26050
419,419,48,201,311200,1,1736,556,1736,1626,110,102,86,6,1,6,0,3,8,1214,1119,95,91,76,5,1,6,0,3,4,556,505,51,482013112001,15000US482013112001,482013112001,31250
420,420,48,201,311200,2,2004,676,2004,1893,111,109,93,12,1,0,0,3,2,1397,1306,91,91,78,10,1,0,0,2,0,676,616,60,482013112002,15000US482013112002,482013112002,21422
421,421,48,201,311200,3,1168,537,1168,1011,157,157,124,32,0,0,1,0,0,877,738,139,139,106,32,0,0,1,0,0,537,399,138,482013112003,15000US482013112003,482013112003,43295
422,422,48,201,311300,1,1686,546,1686,1582,104,103,80,16,3,4,0,0,1,1211,1121,90,89,70,12,3,4,0,0,1,546,489,57,482013113001,15000US482013113001,482013113001,41573
423,423,48,201,311300,2,1586,471,1586,1486,100,100,75,10,5,7,0,3,0,1102,1012,90,90,71,9,3,7,0,0,0,471,436,35,482013113002,15000US482013113002,482013113002,40592
424,424,48,201,311300,3,1970,570,1970,1861,109,97,82,11,2,2,0,0,12,1302,1197,105,95,80,11,2,2,0,0,10,570,522,48,482013113003,15000US482013113003,482013113003,40250
425,425,48,201,311400,1,1496,572,1496,1275,221,220,48,167,2,3,0,0,1,1026,841,185,184,40,139,2,3,0,0,1,572,470,102,482013114001,15000US482013114001,482013114001,28897
426,426,48,201,311500,1,2067,700,2067,1731,336,334,76,50,1,199,1,7,2,1441,1179,262,260,60,36,1,158,1,4,2,700,618,82,482013115001,15000US482013115001,482013115001,22692
427,427,48,201,311500,2,1337,441,1337,1200,137,134,74,31,0,29,0,0,3,932,806,126,123,68,30,0,25,0,0,3,441,404,37,482013115002,15000US482013115002,482013115002,24798
428,428,48,201,311500,3,2249,644,2249,2150,99,93,84,3,1,5,0,0,6,1564,1479,85,80,72,3,1,4,0,0,5,644,596,48,482013115003,15000US482013115003,482013115003,44109
429,429,48,201,311500,4,1958,572,1958,1885,73,72,61,4,0,3,0,4,1,1390,1321,69,68,57,4,0,3,0,4,1,572,521,51,482013115004,15000US482013115004,482013115004,59091
430,430,48,201,311600,1,1287,447,1287,1213,74,68,15,46,0,5,0,2,6,837,784,53,49,9,36,0,4,0,0,4,447,373,74,482013116001,15000US482013116001,482013116001,22473
431,431,48,201,311600,2,2185,839,2185,2076,109,102,17,78,1,3,0,3,7,1412,1325,87,83,15,62,1,2,0,3,4,839,687,152,482013116002,15000US482013116002,482013116002,28029
432,432,48,201,311600,3,631,213,631,508,123,121,51,66,0,4,0,0,2,442,321,121,119,51,64,0,4,0,0,2,213,160,53,482013116003,15000US482013116003,482013116003,38188
433,433,48,201,311700,1,3085,1127,3085,2380,705,692,137,490,0,62,0,3,13,2117,1560,557,548,122,371,0,54,0,1,9,1127,1010,117,482013117001,15000US482013117001,482013117001,30978
434,434,48,201,311700,2,2508,700,2508,2299,209,197,124,62,2,4,0,5,12,1677,1501,176,169,113,48,2,4,0,2,7,700,658,42,482013117002,15000US482013117002,482013117002,41494
435,435,48,201,311800,1,1456,413,1456,1378,78,78,69,5,0,2,0,2,0,994,928,66,66,58,4,0,2,0,2,0,413,385,28,482013118001,15000US482013118001,482013118001,29464
436,436,48,201,311800,2,1759,541,1759,1627,132,130,93,21,7,2,0,7,2,1203,1090,113,111,87,16,2,1,0,5,2,541,477,64,482013118002,15000US482013118002,482013118002,67684
437,437,48,201,311800,3,1327,399,1327,1265,62,60,39,13,1,7,0,0,2,872,820,52,51,35,9,1,6,0,0,1,399,368,31,482013118003,15000US482013118003,482013118003,31776
438,438,48,201,311900,1,1040,338,1040,941,99,93,61,23,1,8,0,0,6,718,631,87,82,54,19,1,8,0,0,5,338,299,39,482013119001,15000US482013119001,482013119001,62316
439,439,48,201,311900,2,1408,432,1408,1257,151,146,92,29,0,23,0,2,5,989,864,125,120,79,22,0,19,0,0,5,432,398,34,482013119002,15000US482013119002,482013119002,27245
440,440,48,201,312000,1,1444,731,1444,185,1259,1223,520,486,4,210,1,2,36,1364,174,1190,1163,495,457,4,204,1,2,27,731,635,96,482013120001,15000US482013120001,482013120001,23125
441,441,48,201,312000,2,2645,720,2645,214,2431,2376,797,1179,8,380,5,7,55,2527,205,2322,2271,782,1089,8,380,5,7,51,720,632,88,482013120002,15000US482013120002,482013120002,23495
442,442,48,201,312100,1,2725,12,2725,389,2336,2326,924,830,13,476,0,83,10,2706,386,2320,2310,918,820,13,476,0,83,10,12,11,1,482013121001,15000US482013121001,482013121001,
443,443,48,201,312200,1,713,381,713,115,598,594,12,579,0,3,0,0,4,511,63,448,444,10,431,0,3,0,0,4,381,272,109,482013122001,15000US482013122001,482013122001,8449
444,444,48,201,312200,2,683,407,683,183,500,494,25,467,0,2,0,0,6,517,108,409,406,22,382,0,2,0,0,3,407,272,135,482013122002,15000US482013122002,482013122002,17976
445,445,48,201,312200,3,662,404,662,105,557,556,8,543,0,4,0,1,1,509,66,443,443,8,430,0,4,0,1,0,404,268,136,482013122003,15000US482013122003,482013122003,9851
446,446,48,201,312300,1,773,452,773,202,571,565,105,418,0,42,0,0,6,625,134,491,486,104,343,0,39,0,0,5,452,331,121,482013123001,15000US482013123001,482013123001,28274
447,447,48,201,312300,2,1189,690,1189,182,1007,1003,29,964,0,7,1,2,4,928,121,807,805,24,771,0,7,1,2,2,690,514,176,482013123002,15000US482013123002,482013123002,13835
448,448,48,201,312400,1,767,455,767,190,577,573,36,524,0,13,0,0,4,582,120,462,459,36,410,0,13,0,0,3,455,331,124,482013124001,15000US482013124001,482013124001,22250
449,449,48,201,312400,2,657,373,657,59,598,596,22,569,0,5,0,0,2,491,36,455,453,20,428,0,5,0,0,2,373,250,123,482013124002,15000US482013124002,482013124002,9597
450,450,48,201,312400,3,784,523,784,33,751,744,24,710,0,9,0,1,7,625,24,601,596,24,564,0,7,0,1,5,523,373,150,482013124003,15000US482013124003,482013124003,24735
451,451,48,201,312500,1,2499,913,2499,333,2166,2122,1011,888,5,211,0,7,44,2260,281,1979,1949,959,788,5,193,0,4,30,913,860,53,482013125001,15000US482013125001,482013125001,94632
452,452,48,201,312500,2,1736,905,1736,421,1315,1288,683,505,5,91,0,4,27,1604,346,1258,1236,665,473,5,89,0,4,22,905,762,143,482013125002,15000US482013125002,482013125002,46673
453,453,48,201,312600,1,2336,1784,2336,306,2030,1977,1363,298,3,306,1,6,53,2138,260,1878,1836,1290,252,3,287,1,3,42,1784,1425,359,482013126001,15000US482013126001,482013126001,64792
454,454,48,201,312600,2,960,1219,960,136,824,794,326,386,0,82,0,0,30,865,119,746,720,314,330,0,76,0,0,26,1219,564,655,482013126002,15000US482013126002,482013126002,100799
455,455,48,201,312600,3,901,495,901,279,622,612,198,348,3,57,0,6,10,695,187,508,501,159,290,2,48,0,2,7,495,384,111,482013126003,15000US482013126003,482013126003,38940
456,456,48,201,312600,4,1674,789,1674,275,1399,1366,742,516,6,99,1,2,33,1465,206,1259,1238,687,459,6,85,1,0,21,789,658,131,482013126004,15000US482013126004,482013126004,68214
457,457,48,201,312700,1,580,353,580,32,548,546,9,530,0,5,0,2,2,467,28,439,437,8,422,0,5,0,2,2,353,258,95,482013127001,15000US482013127001,482013127001,67500
458,458,48,201,312700,2,822,527,822,64,758,735,32,689,1,12,0,1,23,668,39,629,616,29,573,1,12,0,1,13,527,393,134,482013127002,15000US482013127002,482013127002,39659
459,459,48,201,312700,3,553,329,553,40,513,506,36,465,1,2,0,2,7,461,32,429,424,36,383,1,2,0,2,5,329,269,60,482013127003,15000US482013127003,482013127003,40648
460,460,48,201,312800,1,1364,548,1364,129,1235,1227,10,1215,1,0,1,0,8,895,68,827,819,7,810,1,0,1,0,8,548,493,55,482013128001,15000US482013128001,482013128001,8720
461,461,48,201,312800,2,968,180,968,17,951,940,11,925,2,1,1,0,11,899,10,889,878,11,863,2,1,1,0,11,180,162,18,482013128002,15000US482013128002,482013128002,27608
462,462,48,201,312900,1,2725,1412,2725,119,2606,2574,68,2463,6,28,0,9,32,2327,83,2244,2218,64,2112,6,27,0,9,26,1412,1113,299,482013129001,15000US482013129001,482013129001,14885
463,463,48,201,312900,2,1216,690,1216,50,1166,1152,66,1074,4,7,0,1,14,1022,36,986,974,60,903,3,7,0,1,12,690,570,120,482013129002,15000US482013129002,482013129002,42092
464,464,48,201,313000,1,712,435,712,28,684,654,42,606,0,4,0,2,30,564,23,541,528,42,480,0,4,0,2,13,435,331,104,482013130001,15000US482013130001,482013130001,50833
465,465,48,201,313000,2,909,535,909,98,811,797,90,685,2,18,0,2,14,739,71,668,659,86,553,2,18,0,0,9,535,424,111,482013130002,15000US482013130002,482013130002,41477
466,466,48,201,313000,3,728,491,728,35,693,684,32,637,1,9,0,5,9,607,27,580,576,29,537,1,8,0,1,4,491,363,128,482013130003,15000US482013130003,482013130003,27986
467,467,48,201,313100,1,2789,1514,2789,336,2453,2401,1603,520,3,266,2,7,52,2627,307,2320,2277,1535,478,3,252,2,7,43,1514,1286,228,482013131001,15000US482013131001,482013131001,55344
468,468,48,201,313100,2,567,382,567,55,512,502,242,46,1,208,2,3,10,483,43,440,435,218,40,1,171,2,3,5,382,270,112,482013131002,15000US482013131002,482013131002,64018
469,469,48,201,313200,1,857,488,857,30,827,822,80,713,1,27,1,0,5,711,19,692,687,76,588,1,21,1,0,5,488,378,110,482013132001,15000US482013132001,482013132001,63750
470,470,48,201,313200,2,541,345,541,26,515,509,22,482,0,5,0,0,6,414,13,401,397,16,377,0,4,0,0,4,345,221,124,482013132002,15000US482013132002,482013132002,38190
471,471,48,201,313200,3,1540,814,1540,303,1237,1210,57,1122,10,19,0,2,27,1184,201,983,959,52,884,5,18,0,0,24,814,668,146,482013132003,15000US482013132003,482013132003,34302
472,472,48,201,313200,4,860,424,860,28,832,820,69,742,2,5,0,2,12,720,21,699,691,63,620,2,5,0,1,8,424,365,59,482013132004,15000US482013132004,482013132004,59095
473,473,48,201,313300,1,1172,523,1172,188,984,975,31,939,2,2,0,1,9,841,112,729,724,26,693,2,2,0,1,5,523,445,78,482013133001,15000US482013133001,482013133001,31000
474,474,48,201,313300,2,1482,638,1482,173,1309,1303,44,1257,1,0,0,1,6,1187,114,1073,1067,36,1030,1,0,0,0,6,638,576,62,482013133002,15000US482013133002,482013133002,48438
475,475,48,201,313400,1,1177,509,1177,326,851,838,17,818,0,3,0,0,13,874,210,664,653,16,634,0,3,0,0,11,509,449,60,482013134001,15000US482013134001,482013134001,45575
476,476,48,201,313400,2,1758,930,1758,374,1384,1375,37,1317,8,10,0,3,9,1329,210,1119,1113,29,1067,7,9,0,1,6,930,685,245,482013134002,15000US482013134002,482013134002,32526
477,477,48,201,313500,1,833,334,833,146,687,681,4,672,0,5,0,0,6,627,91,536,530,4,521,0,5,0,0,6,334,295,39,482013135001,15000US482013135001,482013135001,20739
478,478,48,201,313500,2,996,423,996,162,834,827,16,809,0,0,0,2,7,712,103,609,604,15,588,0,0,0,1,5,423,349,74,482013135002,15000US482013135002,482013135002,13724
479,479,48,201,313500,3,672,269,672,182,490,485,6,478,1,0,0,0,5,463,104,359,355,4,350,1,0,0,0,4,269,212,57,482013135003,15000US482013135003,482013135003,59615
480,480,48,201,313600,1,1173,470,1173,478,695,695,33,649,7,3,0,3,0,882,302,580,580,30,543,4,3,0,0,0,470,412,58,482013136001,15000US482013136001,482013136001,26905
481,481,48,201,313600,2,1940,690,1940,166,1774,1749,13,1734,2,0,0,0,25,1217,108,1109,1103,12,1089,2,0,0,0,6,690,619,71,482013136002,15000US482013136002,482013136002,18609
482,482,48,201,313600,3,1718,707,1718,592,1126,1112,28,1065,0,19,0,0,14,1279,377,902,893,26,852,0,15,0,0,9,707,596,111,482013136003,15000US482013136003,482013136003,25820
483,483,48,201,313700,1,953,383,953,23,930,921,8,906,2,3,0,2,9,725,16,709,708,8,694,2,2,0,2,1,383,353,30,482013137001,15000US482013137001,482013137001,21302
484,484,48,201,313700,2,1504,640,1504,169,1335,1323,24,1294,0,5,0,0,12,1188,111,1077,1068,23,1040,0,5,0,0,9,640,576,64,482013137002,15000US482013137002,482013137002,35769
485,485,48,201,313800,1,1235,442,1235,67,1168,1166,11,1140,2,12,0,1,2,630,37,593,591,11,569,1,9,0,1,2,442,399,43,482013138001,15000US482013138001,482013138001,14495
486,486,48,201,313800,2,753,449,753,38,715,710,6,702,2,0,0,0,5,626,25,601,596,6,588,2,0,0,0,5,449,381,68,482013138002,15000US482013138002,482013138002,18532
487,487,48,201,313800,3,678,347,678,225,453,446,8,415,2,7,7,7,7,478,123,355,352,8,324,2,7,7,4,3,347,250,97,482013138003,15000US482013138003,482013138003,25882
488,488,48,201,313800,4,2108,796,2108,137,1971,1948,14,1923,5,3,0,3,23,1368,85,1283,1272,8,1255,3,3,0,3,11,796,742,54,482013138004,15000US482013138004,482013138004,26181
489,489,48,201,313900,1,1943,1181,1943,272,1671,1609,668,651,3,284,2,1,62,1676,214,1462,1415,615,529,3,265,2,1,47,1181,979,202,482013139001,15000US482013139001,482013139001,52174
490,490,48,201,313900,2,1635,1046,1635,158,1477,1433,524,469,1,430,0,9,44,1457,137,1320,1283,475,413,1,387,0,7,37,1046,918,128,482013139002,15000US482013139002,482013139002,41725
491,491,48,201,313900,3,917,657,917,104,813,796,260,333,3,199,0,1,17,835,89,746,732,250,293,3,185,0,1,14,657,571,86,482013139003,15000US482013139003,482013139003,48024
492,492,48,201,314001,1,25,24,25,7,18,17,5,0,0,12,0,0,1,25,7,18,17,5,0,0,12,0,0,1,24,15,9,482013140011,15000US482013140011,482013140011,34314
493,493,48,201,314001,2,668,402,668,53,615,600,224,124,0,252,0,0,15,613,47,566,552,216,104,0,232,0,0,14,402,353,49,482013140012,15000US482013140012,482013140012,22473
494,494,48,201,314001,3,2066,1402,2066,207,1859,1770,705,393,9,658,0,5,89,1879,192,1687,1613,664,349,8,588,0,4,74,1402,1238,164,482013140013,15000US482013140013,482013140013,55156
495,495,48,201,314002,1,1493,903,1493,143,1350,1329,254,533,0,529,1,12,21,1373,130,1243,1224,241,467,0,503,1,12,19,903,824,79,482013140021,15000US482013140021,482013140021,37198
496,496,48,201,314002,2,1029,667,1029,114,915,897,291,156,1,436,4,9,18,947,109,838,821,275,145,0,389,4,8,17,667,537,130,482013140022,15000US482013140022,482013140022,46484
497,497,48,201,314002,3,1217,914,1217,120,1097,1068,506,194,0,368,0,0,29,1095,101,994,971,487,164,0,320,0,0,23,914,767,147,482013140023,15000US482013140023,482013140023,54167
498,498,48,201,314002,4,1155,701,1155,140,1015,999,249,267,1,479,1,2,16,1045,126,919,905,215,246,1,440,1,2,14,701,670,31,482013140024,15000US482013140024,482013140024,23629
499,499,48,201,314002,5,2650,1185,2650,246,2404,2371,548,378,1,1440,2,2,33,2425,232,2193,2163,527,317,0,1315,2,2,30,1185,1127,58,482013140025,15000US482013140025,482013140025,34668
500,500,48,201,314300,1,962,607,962,84,878,866,55,758,2,49,0,2,12,731,61,670,662,51,567,2,41,0,1,8,607,506,101,482013143001,15000US482013143001,482013143001,14804
501,501,48,201,314300,2,1059,615,1059,112,947,939,63,832,1,43,0,0,8,841,79,762,758,55,664,1,38,0,0,4,615,588,27,482013143002,15000US482013143002,482013143002,33712
502,502,48,201,314300,3,1941,1254,1941,196,1745,1723,82,1578,7,54,1,1,22,1543,149,1394,1378,78,1243,7,48,1,1,16,1254,999,255,482013143003,15000US482013143003,482013143003,24556
503,503,48,201,314400,1,1216,1003,1216,125,1091,1049,448,112,0,483,1,5,42,1040,106,934,906,419,104,0,379,1,3,28,1003,699,304,482013144001,15000US482013144001,482013144001,49297
504,504,48,201,314400,2,1877,1324,1877,208,1669,1618,691,117,0,805,1,4,51,1656,186,1470,1429,644,109,0,674,1,1,41,1324,1092,232,482013144002,15000US482013144002,482013144002,41224
505,505,48,201,320100,1,1872,727,1872,1662,210,203,103,88,5,7,0,0,7,1262,1089,173,167,84,72,4,7,0,0,6,727,609,118,482013201001,15000US482013201001,482013201001,32635
506,506,48,201,320100,2,1004,341,1004,863,141,136,63,28,0,45,0,0,5,692,581,111,107,57,19,0,31,0,0,4,341,299,42,482013201002,15000US482013201002,482013201002,38750
507,507,48,201,320200,1,2205,689,2205,2035,170,162,96,53,4,5,0,4,8,1476,1337,139,133,83,41,3,5,0,1,6,689,627,62,482013202001,15000US482013202001,482013202001,31400
508,508,48,201,320200,2,931,326,931,817,114,114,81,27,1,4,0,1,0,566,474,92,92,69,17,1,4,0,1,0,326,267,59,482013202002,15000US482013202002,482013202002,17986
509,509,48,201,320200,3,1284,480,1284,528,756,743,146,23,8,565,0,1,13,964,364,600,589,136,21,7,424,0,1,11,480,421,59,482013202003,15000US482013202003,482013202003,39523
510,510,48,201,320200,4,2242,751,2242,1715,527,520,172,56,3,281,0,8,7,1531,1123,408,402,153,42,2,200,0,5,6,751,671,80,482013202004,15000US482013202004,482013202004,27014
511,511,48,201,320500,1,2413,653,2413,2149,264,261,240,13,5,3,0,0,3,1602,1371,231,230,213,10,4,3,0,0,1,653,618,35,482013205001,15000US482013205001,482013205001,29286
512,512,48,201,320500,2,2205,577,2205,1972,233,221,206,7,3,5,0,0,12,1460,1270,190,183,176,2,2,3,0,0,7,577,545,32,482013205002,15000US482013205002,482013205002,56356
513,513,48,201,320601,1,2638,863,2638,2347,291,284,239,24,0,18,0,3,7,1771,1519,252,248,210,23,0,14,0,1,4,863,777,86,482013206011,15000US482013206011,482013206011,32470
514,514,48,201,320602,1,1401,624,1401,1169,232,225,70,148,0,6,0,1,7,996,791,205,198,64,128,0,6,0,0,7,624,492,132,482013206021,15000US482013206021,482013206021,26813
515,515,48,201,320602,2,1496,409,1496,1379,117,113,100,7,0,6,0,0,4,974,876,98,96,86,5,0,5,0,0,2,409,370,39,482013206022,15000US482013206022,482013206022,38644
516,516,48,201,320602,3,1640,469,1640,1505,135,132,93,15,1,23,0,0,3,1130,1010,120,119,85,14,0,20,0,0,1,469,424,45,482013206023,15000US482013206023,482013206023,25729
517,517,48,201,320700,1,2723,1204,2723,1905,818,804,480,270,6,46,0,2,14,1896,1216,680,669,437,188,6,37,0,1,11,1204,935,269,482013207001,15000US482013207001,482013207001,41932
518,518,48,201,320700,2,1126,418,1126,712,414,408,54,53,1,300,0,0,6,826,503,323,322,51,37,1,233,0,0,1,418,398,20,482013207002,15000US482013207002,482013207002,37976
519,519,48,201,320900,1,1598,907,1598,765,833,822,125,665,2,21,7,2,11,1123,509,614,607,101,477,0,20,7,2,7,907,650,257,482013209001,15000US482013209001,482013209001,25282
520,520,48,201,320900,2,1981,522,1981,1691,290,285,230,40,5,10,0,0,5,1287,1058,229,225,186,25,5,9,0,0,4,522,500,22,482013209002,15000US482013209002,482013209002,41078
521,521,48,201,320900,3,1933,542,1933,1522,411,396,309,47,4,34,0,2,15,1327,988,339,338,271,35,3,28,0,1,1,542,531,11,482013209003,15000US482013209003,482013209003,41250
522,522,48,201,320900,4,1882,515,1882,1509,373,368,290,36,1,39,1,1,5,1303,991,312,309,253,22,1,32,1,0,3,515,497,18,482013209004,15000US482013209004,482013209004,50547
523,523,48,201,321000,1,1304,390,1304,1038,266,264,226,23,0,15,0,0,2,925,685,240,238,208,17,0,13,0,0,2,390,374,16,482013210001,15000US482013210001,482013210001,46842
524,524,48,201,321000,2,977,293,977,717,260,258,204,32,1,20,0,1,2,656,444,212,210,178,17,1,13,0,1,2,293,286,7,482013210002,15000US482013210002,482013210002,38808
525,525,48,201,321000,3,1369,805,1369,923,446,435,113,280,1,41,0,0,11,887,558,329,324,95,201,1,27,0,0,5,805,484,321,482013210003,15000US482013210003,482013210003,35513
526,526,48,201,321000,4,1203,385,1203,978,225,220,165,36,1,18,0,0,5,825,637,188,185,145,25,1,14,0,0,3,385,370,15,482013210004,15000US482013210004,482013210004,29779
527,527,48,201,321000,5,2655,789,2655,2066,589,564,492,42,1,28,0,1,25,1818,1313,505,493,432,33,1,26,0,1,12,789,751,38,482013210005,15000US482013210005,482013210005,48476
528,528,48,201,321100,1,3485,1530,3485,1960,1525,1492,561,647,11,264,5,4,33,2523,1305,1218,1199,479,497,7,209,3,4,19,1530,1399,131,482013211001,15000US482013211001,482013211001,45189
529,529,48,201,321100,2,2934,892,2934,2109,825,807,495,132,4,167,0,9,18,1951,1301,650,639,416,87,2,131,0,3,11,892,854,38,482013211002,15000US482013211002,482013211002,54375
530,530,48,201,321100,3,978,295,978,672,306,299,230,16,1,43,5,4,7,668,428,240,235,190,13,1,25,3,3,5,295,283,12,482013211003,15000US482013211003,482013211003,35852
531,531,48,201,321200,1,1156,352,1156,868,288,276,135,124,0,17,0,0,12,672,491,181,178,106,59,0,13,0,0,3,352,337,15,482013212001,15000US482013212001,482013212001,24263
532,532,48,201,321200,2,1475,425,1475,1320,155,155,144,10,1,0,0,0,0,940,808,132,132,124,7,1,0,0,0,0,425,406,19,482013212002,15000US482013212002,482013212002,26612
533,533,48,201,321300,1,2122,838,2122,1710,412,402,126,249,1,26,0,0,10,1375,1072,303,300,114,164,1,21,0,0,3,838,715,123,482013213001,15000US482013213001,482013213001,35198
534,534,48,201,321300,2,1746,753,1746,1313,433,427,150,264,8,4,0,1,6,1125,842,283,280,111,158,6,4,0,1,3,753,560,193,482013213002,15000US482013213002,482013213002,22768
535,535,48,201,321300,3,1678,560,1678,1207,471,464,412,31,6,15,0,0,7,1232,801,431,425,387,22,3,13,0,0,6,560,503,57,482013213003,15000US482013213003,482013213003,43021
536,536,48,201,321600,3,15,6,15,6,9,9,5,0,0,4,0,0,0,12,3,9,9,5,0,0,4,0,0,0,6,6,0,482013216003,15000US482013216003,482013216003,35893
537,537,48,201,321700,1,1452,513,1452,962,490,488,470,10,0,7,1,0,2,1052,610,442,440,427,8,0,4,1,0,2,513,491,22,482013217001,15000US482013217001,482013217001,60600
538,538,48,201,321700,2,1597,498,1597,1313,284,276,238,15,4,12,0,7,8,1098,839,259,254,222,14,4,9,0,5,5,498,463,35,482013217002,15000US482013217002,482013217002,49123
539,539,48,201,321800,1,1943,531,1943,1725,218,217,185,27,2,3,0,0,1,1292,1103,189,189,169,16,1,3,0,0,0,531,500,31,482013218001,15000US482013218001,482013218001,38423
540,540,48,201,321800,2,2165,625,2165,1889,276,272,231,22,2,12,0,5,4,1485,1243,242,241,211,16,1,9,0,4,1,625,600,25,482013218002,15000US482013218002,482013218002,41458
541,541,48,201,324000,2,243,84,243,127,116,116,70,6,0,40,0,0,0,187,93,94,94,63,5,0,26,0,0,0,84,76,8,482013240002,15000US482013240002,482013240002,81362
542,542,48,201,324100,2,0,0,0,0,0,0,0,0,0,0,0,0,0,0,0,0,0,0,0,0,0,0,0,0,0,0,0,482013241002,15000US482013241002,482013241002,20375
543,543,48,201,324100,3,0,0,0,0,0,0,0,0,0,0,0,0,0,0,0,0,0,0,0,0,0,0,0,0,0,0,0,482013241003,15000US482013241003,482013241003,38750
544,544,48,201,324200,1,1647,471,1647,1550,97,96,58,24,7,7,0,0,1,1101,1031,70,70,49,11,4,6,0,0,0,471,437,34,482013242001,15000US482013242001,482013242001,32961
545,545,48,201,330100,1,1359,381,1359,803,556,543,13,507,0,21,0,2,13,947,529,418,411,12,379,0,19,0,1,7,381,368,13,482013301001,15000US482013301001,482013301001,27254
546,546,48,201,330100,2,1706,490,1706,935,771,766,18,725,0,19,0,4,5,1177,617,560,556,14,521,0,19,0,2,4,490,477,13,482013301002,15000US482013301002,482013301002,32438
547,547,48,201,330100,3,2674,649,2674,1678,996,979,16,946,0,16,0,1,17,1701,1043,658,653,12,625,0,15,0,1,5,649,631,18,482013301003,15000US482013301003,482013301003,28446
548,548,48,201,330100,4,2574,812,2574,1328,1246,1243,41,1169,1,25,0,7,3,1783,816,967,966,36,902,1,24,0,3,1,812,752,60,482013301004,15000US482013301004,482013301004,40212
549,549,48,201,330200,1,2388,703,2388,1261,1127,1118,77,1006,4,28,0,3,9,1610,771,839,836,61,744,4,26,0,1,3,703,656,47,482013302001,15000US482013302001,482013302001,44274
550,550,48,201,330200,2,1855,667,1855,944,911,891,68,818,2,3,0,0,20,1328,613,715,702,61,636,2,3,0,0,13,667,624,43,482013302002,15000US482013302002,482013302002,29415
551,551,48,201,330301,1,4489,1209,4489,2922,1567,1534,118,1243,10,159,2,2,33,2853,1789,1064,1044,85,827,2,128,2,0,20,1209,1172,37,482013303011,15000US482013303011,482013303011,56964
552,552,48,201,330301,2,2680,635,2680,2089,591,579,106,374,0,93,0,6,12,1658,1255,403,398,74,247,0,74,0,3,5,635,626,9,482013303012,15000US482013303012,482013303012,53133
553,553,48,201,330302,1,2371,652,2371,1866,505,494,64,405,1,18,0,6,11,1543,1222,321,315,53,245,0,14,0,3,6,652,606,46,482013303021,15000US482013303021,482013303021,45327
554,554,48,201,330302,2,1259,412,1259,538,721,713,95,613,0,4,1,0,8,929,342,587,580,87,488,0,4,1,0,7,412,386,26,482013303022,15000US482013303022,482013303022,29531
555,555,48,201,330302,3,1897,721,1897,733,1164,1146,61,1069,8,7,0,1,18,1358,449,909,898,53,835,5,4,0,1,11,721,574,147,482013303023,15000US482013303023,482013303023,46488
556,556,48,201,330303,1,1467,564,1467,996,471,464,58,398,0,7,0,1,7,939,602,337,335,55,275,0,5,0,0,2,564,451,113,482013303031,15000US482013303031,482013303031,33697
557,557,48,201,330303,2,1448,591,1448,734,714,702,152,539,5,6,0,0,12,1045,467,578,571,146,416,3,6,0,0,7,591,553,38,482013303032,15000US482013303032,482013303032,41912
558,558,48,201,330303,3,1146,376,1146,259,887,886,17,852,0,17,0,0,1,831,169,662,661,15,632,0,14,0,0,1,376,373,3,482013303033,15000US482013303033,482013303033,102656
559,559,48,201,330400,1,1270,355,1270,951,319,318,59,247,0,12,0,0,1,850,603,247,246,54,180,0,12,0,0,1,355,332,23,482013304001,15000US482013304001,482013304001,33558
560,560,48,201,330400,2,1779,546,1779,1126,653,643,76,561,1,1,0,4,10,1212,720,492,488,65,421,1,1,0,0,4,546,503,43,482013304002,15000US482013304002,482013304002,34798
561,561,48,201,330400,3,1614,601,1614,422,1192,1180,34,1123,3,11,0,9,12,1162,294,868,865,30,820,3,10,0,2,3,601,586,15,482013304003,15000US482013304003,482013304003,27887
562,562,48,201,330500,1,1582,442,1582,1129,453,444,66,372,5,1,0,0,9,993,649,344,337,51,280,5,1,0,0,7,442,416,26,482013305001,15000US482013305001,482013305001,28835
563,563,48,201,330500,2,1468,416,1468,744,724,715,28,678,1,4,0,4,9,1052,508,544,536,25,505,0,4,0,2,8,416,394,22,482013305002,15000US482013305002,482013305002,55387
564,564,48,201,330500,3,1071,346,1071,487,584,576,50,524,0,0,0,2,8,762,318,444,438,42,396,0,0,0,0,6,346,322,24,482013305003,15000US482013305003,482013305003,39250
565,565,48,201,330600,1,1333,425,1333,589,744,739,27,710,1,1,0,0,5,943,393,550,546,22,522,1,1,0,0,4,425,403,22,482013306001,15000US482013306001,482013306001,53558
566,566,48,201,330600,2,2095,709,2095,740,1355,1342,94,1174,2,72,0,0,13,1438,492,946,938,80,795,2,61,0,0,8,709,655,54,482013306002,15000US482013306002,482013306002,35855
567,567,48,201,330600,3,721,253,721,243,478,473,34,438,1,0,0,0,5,536,160,376,374,32,341,1,0,0,0,2,253,233,20,482013306003,15000US482013306003,482013306003,62533
568,568,48,201,330600,4,2275,678,2275,919,1356,1341,76,1247,6,8,0,4,15,1611,594,1017,1006,69,924,3,8,0,2,11,678,642,36,482013306004,15000US482013306004,482013306004,41250
569,569,48,201,330700,1,2189,578,2189,1390,799,787,42,740,3,2,0,0,12,1261,787,474,470,34,433,1,2,0,0,4,578,523,55,482013307001,15000US482013307001,482013307001,38051
570,570,48,201,330700,2,1700,493,1700,956,744,739,35,699,2,3,0,0,5,1213,656,557,554,20,530,1,3,0,0,3,493,471,22,482013307002,15000US482013307002,482013307002,40962
571,571,48,201,330700,3,1542,439,1542,1126,416,406,33,363,2,7,0,1,10,1040,728,312,308,31,272,0,5,0,0,4,439,424,15,482013307003,15000US482013307003,482013307003,29718
572,572,48,201,330800,1,2525,860,2525,1186,1339,1321,241,989,5,82,0,4,18,1721,743,978,970,209,692,4,62,0,3,8,860,788,72,482013308001,15000US482013308001,482013308001,32139
573,573,48,201,330800,2,5,2,5,0,5,5,0,3,0,2,0,0,0,4,0,4,4,0,2,0,2,0,0,0,2,2,0,482013308002,15000US482013308002,482013308002,66216
574,574,48,201,330900,1,5186,2131,5186,1137,4049,3976,451,3218,6,292,0,9,73,3752,752,3000,2960,408,2310,5,232,0,5,40,2131,2009,122,482013309001,15000US482013309001,482013309001,52119
575,575,48,201,330900,2,1245,425,1245,762,483,475,101,356,1,17,0,0,8,822,475,347,340,86,241,1,12,0,0,7,425,347,78,482013309002,15000US482013309002,482013309002,36638
576,576,48,201,330900,3,1455,405,1455,1144,311,306,124,179,0,0,0,3,5,871,646,225,223,97,124,0,0,0,2,2,405,375,30,482013309003,15000US482013309003,482013309003,49471
577,577,48,201,331100,1,522,265,522,71,451,449,5,444,0,0,0,0,2,398,41,357,355,5,350,0,0,0,0,2,265,206,59,482013311001,15000US482013311001,482013311001,19583
578,578,48,201,331100,2,545,212,545,93,452,449,12,437,0,0,0,0,3,417,69,348,347,11,336,0,0,0,0,1,212,182,30,482013311002,15000US482013311002,482013311002,41786
579,579,48,201,331100,3,1427,577,1427,103,1324,1319,18,1293,3,4,0,1,5,931,60,871,869,13,851,3,1,0,1,2,577,505,72,482013311003,15000US482013311003,482013311003,18828
580,580,48,201,331100,4,1349,607,1349,194,1155,1150,18,1128,1,2,1,0,5,982,119,863,860,16,840,1,2,1,0,3,607,507,100,482013311004,15000US482013311004,482013311004,17273
581,581,48,201,331200,1,1661,750,1661,106,1555,1539,20,1511,1,3,1,3,16,1170,75,1095,1083,20,1055,1,3,1,3,12,750,633,117,482013312001,15000US482013312001,482013312001,16714
582,582,48,201,331200,2,1812,913,1812,116,1696,1689,31,1655,2,0,0,1,7,1297,65,1232,1226,22,1202,1,0,0,1,6,913,792,121,482013312002,15000US482013312002,482013312002,31154
583,583,48,201,331300,1,1419,551,1419,67,1352,1346,7,1335,3,1,0,0,6,1052,45,1007,1005,5,996,3,1,0,0,2,551,505,46,482013313001,15000US482013313001,482013313001,37411
584,584,48,201,331300,2,945,407,945,100,845,840,3,835,0,2,0,0,5,735,58,677,674,2,671,0,1,0,0,3,407,360,47,482013313002,15000US482013313002,482013313002,19091
585,585,48,201,331300,3,787,325,787,56,731,729,1,728,0,0,0,0,2,626,29,597,596,1,595,0,0,0,0,1,325,301,24,482013313003,15000US482013313003,482013313003,36429
586,586,48,201,331300,4,1496,630,1496,95,1401,1396,4,1391,0,1,0,0,5,1170,50,1120,1117,4,1112,0,1,0,0,3,630,563,67,482013313004,15000US482013313004,482013313004,41071
587,587,48,201,331400,1,2520,1098,2520,88,2432,2412,11,2371,3,26,0,1,20,1514,45,1469,1460,11,1424,1,23,0,1,9,1098,1011,87,482013314001,15000US482013314001,482013314001,12966
588,588,48,201,331500,1,858,364,858,11,847,841,3,832,3,3,0,0,6,694,7,687,686,1,680,2,3,0,0,1,364,342,22,482013315001,15000US482013315001,482013315001,25054
589,589,48,201,331500,2,732,318,732,34,698,695,0,695,0,0,0,0,3,583,14,569,568,0,568,0,0,0,0,1,318,283,35,482013315002,15000US482013315002,482013315002,25927
590,590,48,201,331500,3,650,280,650,24,626,621,2,612,4,2,0,1,5,500,16,484,481,1,476,2,2,0,0,3,280,261,19,482013315003,15000US482013315003,482013315003,20957
591,591,48,201,331500,4,1165,438,1165,40,1125,1122,6,1109,7,0,0,0,3,906,20,886,885,5,876,4,0,0,0,1,438,424,14,482013315004,15000US482013315004,482013315004,28229
592,592,48,201,331500,5,820,324,820,30,790,784,1,778,3,2,0,0,6,656,20,636,634,1,628,3,2,0,0,2,324,309,15,482013315005,15000US482013315005,482013315005,56029
593,593,48,201,331500,6,2920,1096,2920,641,2279,2253,210,1973,3,57,0,10,26,2091,393,1698,1683,188,1435,3,51,0,6,15,1096,1017,79,482013315006,15000US482013315006,482013315006,42250
594,594,48,201,331601,1,2072,767,2072,125,1947,1944,14,1918,3,9,0,0,3,1562,69,1493,1492,13,1469,2,8,0,0,1,767,723,44,482013316011,15000US482013316011,482013316011,37071
595,595,48,201,331601,2,2407,1069,2407,102,2305,2291,23,2261,1,6,0,0,14,1746,60,1686,1678,19,1654,1,4,0,0,8,1069,876,193,482013316012,15000US482013316012,482013316012,29651
596,596,48,201,331601,3,1250,434,1250,214,1036,1027,9,1016,0,1,0,1,9,875,120,755,749,5,742,0,1,0,1,6,434,409,25,482013316013,15000US482013316013,482013316013,52092
597,597,48,201,331601,4,729,268,729,37,692,689,0,684,2,2,0,1,3,574,28,546,543,0,539,1,2,0,1,3,268,257,11,482013316014,15000US482013316014,482013316014,57120
598,598,48,201,331602,1,721,328,721,252,469,462,59,396,2,5,0,0,7,484,149,335,330,52,272,2,4,0,0,5,328,252,76,482013316021,15000US482013316021,482013316021,17651
599,599,48,201,331602,2,1619,1283,1619,86,1533,1511,7,1502,1,0,0,1,22,1043,41,1002,988,7,979,1,0,0,1,14,1283,550,733,482013316022,15000US482013316022,482013316022,16289
600,600,48,201,331700,1,1676,599,1676,237,1439,1420,25,1388,3,1,0,3,19,1013,140,873,864,19,841,3,1,0,0,9,599,541,58,482013317001,15000US482013317001,482013317001,20278
601,601,48,201,331700,2,945,341,945,85,860,857,5,849,3,0,0,0,3,721,44,677,674,5,666,3,0,0,0,3,341,320,21,482013317002,15000US482013317002,482013317002,33828
602,602,48,201,331700,3,1350,552,1350,82,1268,1267,4,1260,1,2,0,0,1,1065,51,1014,1013,4,1006,1,2,0,0,1,552,507,45,482013317003,15000US482013317003,482013317003,22273
603,603,48,201,331800,1,2652,1076,2652,228,2424,2402,34,2356,8,4,0,0,22,1824,135,1689,1673,26,1642,1,4,0,0,16,1076,911,165,482013318001,15000US482013318001,482013318001,27344
604,604,48,201,331800,2,1030,353,1030,211,819,810,10,796,2,2,0,0,9,751,126,625,620,10,607,2,1,0,0,5,353,322,31,482013318002,15000US482013318002,482013318002,30324
605,605,48,201,331900,1,895,392,895,53,842,836,5,823,2,4,0,2,6,680,30,650,646,4,634,2,4,0,2,4,392,339,53,482013319001,15000US482013319001,482013319001,37500
606,606,48,201,331900,2,1406,503,1406,135,1271,1266,12,1245,5,2,0,2,5,1076,81,995,991,12,971,4,2,0,2,4,503,463,40,482013319002,15000US482013319002,482013319002,32214
607,607,48,201,331900,3,1063,424,1063,85,978,975,12,963,0,0,0,0,3,771,52,719,717,10,707,0,0,0,0,2,424,372,52,482013319003,15000US482013319003,482013319003,33194
608,608,48,201,332000,1,1821,620,1821,494,1327,1324,11,1310,0,3,0,0,3,1265,299,966,963,10,951,0,2,0,0,3,620,554,66,482013320001,15000US482013320001,482013320001,38667
609,609,48,201,332000,2,849,291,849,186,663,653,14,633,0,0,0,6,10,636,117,519,511,11,494,0,0,0,6,8,291,263,28,482013320002,15000US482013320002,482013320002,45625
610,610,48,201,332000,3,2356,842,2356,338,2018,1998,20,1904,1,72,0,1,20,1370,197,1173,1159,20,1097,1,40,0,1,14,842,713,129,482013320003,15000US482013320003,482013320003,14157
611,611,48,201,332000,4,567,305,567,30,537,532,2,529,1,0,0,0,5,458,18,440,435,2,432,1,0,0,0,5,305,260,45,482013320004,15000US482013320004,482013320004,41250
612,612,48,201,332100,1,1507,519,1507,757,750,746,16,727,1,2,0,0,4,1040,449,591,590,14,573,1,2,0,0,1,519,450,69,482013321001,15000US482013321001,482013321001,28047
613,613,48,201,332100,2,1530,472,1530,714,816,812,23,783,0,2,0,4,4,1054,422,632,628,19,603,0,2,0,4,4,472,431,41,482013321002,15000US482013321002,482013321002,33520
614,614,48,201,332200,1,1801,556,1801,881,920,912,16,881,3,8,1,3,8,1259,555,704,702,15,675,2,6,1,3,2,556,513,43,482013322001,15000US482013322001,482013322001,32727
615,615,48,201,332200,2,2432,800,2432,842,1590,1579,22,1550,2,3,0,2,11,1734,495,1239,1231,17,1207,2,3,0,2,8,800,726,74,482013322002,15000US482013322002,482013322002,34336
616,616,48,201,332200,3,752,267,752,264,488,486,14,472,0,0,0,0,2,542,159,383,382,12,370,0,0,0,0,1,267,231,36,482013322003,15000US482013322003,482013322003,24223
617,617,48,201,332300,1,1319,451,1319,257,1062,1052,7,1034,7,2,2,0,10,996,153,843,839,5,827,4,2,1,0,4,451,427,24,482013323001,15000US482013323001,482013323001,31778
618,618,48,201,332300,2,1599,611,1599,414,1185,1180,27,1143,2,4,0,4,5,1192,257,935,931,18,904,1,4,0,4,4,611,537,74,482013323002,15000US482013323002,482013323002,26201
619,619,48,201,332400,1,1368,508,1368,222,1146,1142,8,1128,0,0,0,6,4,1051,148,903,899,7,891,0,0,0,1,4,508,461,47,482013324001,15000US482013324001,482013324001,29615
620,620,48,201,332400,2,1611,590,1611,202,1409,1396,23,1371,0,0,0,2,13,1238,110,1128,1122,18,1103,0,0,0,1,6,590,555,35,482013324002,15000US482013324002,482013324002,39647
621,621,48,201,332400,3,1292,426,1292,133,1159,1148,30,1104,6,8,0,0,11,1069,113,956,945,29,906,3,7,0,0,11,426,407,19,482013324003,15000US482013324003,482013324003,39775
622,622,48,201,332500,1,2024,646,2024,850,1174,1171,100,1058,4,1,0,8,3,1437,512,925,923,94,818,3,1,0,7,2,646,613,33,482013325001,15000US482013325001,482013325001,44145
623,623,48,201,332500,2,1233,435,1233,634,599,597,81,508,2,6,0,0,2,934,419,515,515,75,434,2,4,0,0,0,435,403,32,482013325002,15000US482013325002,482013325002,59120
624,624,48,201,332600,1,1351,361,1351,1227,124,124,89,30,0,5,0,0,0,924,817,107,107,79,24,0,4,0,0,0,361,342,19,482013326001,15000US482013326001,482013326001,40491
625,625,48,201,332600,2,2335,820,2335,1491,844,840,100,697,12,29,0,2,4,1705,989,716,712,89,588,8,25,0,2,4,820,796,24,482013326002,15000US482013326002,482013326002,30880
626,626,48,201,332600,3,1650,472,1650,900,750,745,55,674,5,5,1,5,5,1103,525,578,573,54,506,5,5,1,2,5,472,449,23,482013326003,15000US482013326003,482013326003,47283
627,627,48,201,332600,4,1269,445,1269,512,757,750,19,728,1,0,0,2,7,874,304,570,567,17,547,1,0,0,2,3,445,421,24,482013326004,15000US482013326004,482013326004,42136
628,628,48,201,332700,1,843,265,843,776,67,65,48,14,0,3,0,0,2,556,498,58,56,41,12,0,3,0,0,2,265,242,23,482013327001,15000US482013327001,482013327001,34050
629,629,48,201,332700,2,1885,559,1885,1690,195,193,115,65,2,10,0,1,2,1323,1161,162,160,100,50,2,7,0,1,2,559,521,38,482013327002,15000US482013327002,482013327002,39570
630,630,48,201,332800,1,1163,423,1163,938,225,224,76,139,2,6,0,1,1,794,594,200,199,72,119,1,6,0,1,1,423,315,108,482013328001,15000US482013328001,482013328001,24167
631,631,48,201,332800,2,1226,418,1226,1129,97,94,52,38,2,2,0,0,3,817,732,85,82,44,34,2,2,0,0,3,418,364,54,482013328002,15000US482013328002,482013328002,41019
632,632,48,201,332800,3,2228,655,2228,1888,340,335,66,263,0,5,0,1,5,1453,1234,219,216,58,153,0,5,0,0,3,655,595,60,482013328003,15000US482013328003,482013328003,25609
633,633,48,201,332900,1,2352,721,2352,2207,145,139,96,39,3,1,0,0,6,1517,1390,127,124,87,35,1,1,0,0,3,721,622,99,482013329001,15000US482013329001,482013329001,36036
634,634,48,201,332900,2,2697,781,2697,2267,430,418,248,134,4,29,1,2,12,1894,1508,386,380,222,124,4,27,1,2,6,781,697,84,482013329002,15000US482013329002,482013329002,41488
635,635,48,201,333000,1,2530,752,2530,2187,343,341,232,69,0,40,0,0,2,1775,1476,299,297,206,52,0,39,0,0,2,752,705,47,482013330001,15000US482013330001,482013330001,55724
636,636,48,201,333000,2,785,311,785,670,115,111,90,12,2,7,0,0,4,549,439,110,109,88,12,2,7,0,0,1,311,238,73,482013330002,15000US482013330002,482013330002,53378
637,637,48,201,333100,1,1548,560,1548,877,671,664,123,509,0,30,0,2,7,1070,569,501,495,110,366,0,19,0,0,6,560,494,66,482013331001,15000US482013331001,482013331001,24201
638,638,48,201,333100,2,2115,834,2115,753,1362,1349,172,184,0,985,0,8,13,1534,509,1025,1017,158,143,0,708,0,8,8,834,744,90,482013331002,15000US482013331002,482013331002,31289
639,639,48,201,333201,1,1862,710,1862,1294,568,563,87,412,1,55,0,8,5,1287,854,433,431,70,309,1,46,0,5,2,710,598,112,482013332011,15000US482013332011,482013332011,19772
640,640,48,201,333201,2,2135,795,2135,1645,490,486,61,393,3,21,0,8,4,1501,1128,373,370,54,294,3,16,0,3,3,795,725,70,482013332012,15000US482013332012,482013332012,31786
641,641,48,201,333201,3,1001,289,1001,704,297,289,148,122,1,18,0,0,8,705,459,246,240,134,91,0,15,0,0,6,289,282,7,482013332013,15000US482013332013,482013332013,42955
642,642,48,201,333202,1,945,326,945,665,280,275,158,99,1,11,2,4,5,646,421,225,222,137,73,1,7,2,2,3,326,296,30,482013332021,15000US482013332021,482013332021,73750
643,643,48,201,333202,2,1275,520,1275,785,490,479,130,310,1,35,0,3,11,916,518,398,390,120,236,1,30,0,3,8,520,460,60,482013332022,15000US482013332022,482013332022,24545
644,644,48,201,333202,3,1915,904,1915,1136,779,774,62,695,5,11,0,1,5,1340,748,592,589,56,519,5,8,0,1,3,904,775,129,482013332023,15000US482013332023,482013332023,28037
645,645,48,201,333202,4,1539,814,1539,887,652,652,40,603,1,7,0,1,0,1088,600,488,488,34,446,1,7,0,0,0,814,641,173,482013332024,15000US482013332024,482013332024,28208
646,646,48,201,333300,1,1511,484,1511,1205,306,293,180,79,3,30,1,0,13,994,751,243,234,149,57,2,25,1,0,9,484,443,41,482013333001,15000US482013333001,482013333001,35833
647,647,48,201,333300,2,5858,2285,5858,3549,2309,2264,315,1864,1,82,0,2,45,3683,2223,1460,1441,265,1111,1,64,0,0,19,2285,2005,280,482013333002,15000US482013333002,482013333002,31330
648,648,48,201,333300,3,2003,580,2003,1627,376,359,139,100,0,118,0,2,17,1360,1057,303,287,122,70,0,95,0,0,16,580,543,37,482013333003,15000US482013333003,482013333003,52500
649,649,48,201,333500,1,1860,674,1860,1318,542,529,94,407,1,27,0,0,13,1233,842,391,382,86,271,1,24,0,0,9,674,596,78,482013335001,15000US482013335001,482013335001,33819
650,650,48,201,333500,2,2453,851,2453,1844,609,591,219,341,3,25,0,3,18,1676,1176,500,485,201,256,3,23,0,2,15,851,721,130,482013335002,15000US482013335002,482013335002,34010
651,651,48,201,333500,3,2120,904,2120,1449,671,654,88,537,3,23,2,1,17,1470,951,519,508,83,399,3,20,2,1,11,904,741,163,482013335003,15000US482013335003,482013335003,25078
652,652,48,201,333600,1,1088,461,1088,656,432,422,303,100,5,14,0,0,10,829,457,372,368,269,85,1,13,0,0,4,461,389,72,482013336001,15000US482013336001,482013336001,33983
653,653,48,201,333600,2,1024,349,1024,639,385,374,259,104,3,8,0,0,11,751,429,322,315,222,84,3,6,0,0,7,349,332,17,482013336002,15000US482013336002,482013336002,56429
654,654,48,201,333600,3,1044,378,1044,607,437,431,314,95,3,13,0,6,6,759,405,354,352,263,71,2,11,0,5,2,378,351,27,482013336003,15000US482013336003,482013336003,73250
655,655,48,201,333700,1,2094,607,2094,1608,486,476,194,174,6,101,0,1,10,1412,1027,385,378,165,130,3,79,0,1,7,607,579,28,482013337001,15000US482013337001,482013337001,49604
656,656,48,201,333700,2,1062,366,1062,794,268,264,193,48,0,22,0,1,4,734,510,224,220,168,35,0,17,0,0,4,366,327,39,482013337002,15000US482013337002,482013337002,50987
657,657,48,201,333800,1,1937,534,1937,1714,223,217,149,41,1,25,0,1,6,1211,1033,178,174,120,32,1,20,0,1,4,534,506,28,482013338001,15000US482013338001,482013338001,30054
658,658,48,201,333800,2,2139,705,2139,1617,522,506,179,274,0,40,0,13,16,1443,1021,422,410,171,199,0,34,0,6,12,705,652,53,482013338002,15000US482013338002,482013338002,48164
659,659,48,201,333800,3,1538,590,1538,807,731,713,150,541,1,17,1,3,18,1061,504,557,549,132,397,1,17,1,1,8,590,462,128,482013338003,15000US482013338003,482013338003,27904
660,660,48,201,333800,4,1804,515,1804,1374,430,414,190,142,0,79,2,1,16,1266,926,340,328,156,112,0,57,2,1,12,515,493,22,482013338004,15000US482013338004,482013338004,44245
661,661,48,201,333800,5,1810,563,1810,1071,739,728,167,509,0,51,1,0,11,1282,699,583,577,142,390,0,44,1,0,6,563,546,17,482013338005,15000US482013338005,482013338005,68839
662,662,48,201,333901,1,4858,1286,4858,2916,1942,1905,335,665,4,890,1,10,37,3126,1785,1341,1326,246,446,4,623,0,7,15,1286,1257,29,482013339011,15000US482013339011,482013339011,67281
663,663,48,201,333901,2,3453,960,3453,2132,1321,1288,325,459,7,496,0,1,33,2189,1269,920,910,260,301,2,346,0,1,10,960,927,33,482013339012,15000US482013339012,482013339012,72917
664,664,48,201,333902,1,3476,1219,3476,2173,1303,1275,510,575,6,178,3,3,28,2349,1357,992,975,444,391,6,129,3,2,17,1219,1153,66,482013339021,15000US482013339021,482013339021,36047
665,665,48,201,333902,2,3025,912,3025,1879,1146,1115,556,308,3,240,2,6,31,2090,1202,888,869,457,217,3,189,2,1,19,912,887,25,482013339022,15000US482013339022,482013339022,61094
666,666,48,201,333902,3,1716,923,1716,793,923,894,228,522,5,133,6,0,29,1313,570,743,720,198,406,3,109,4,0,23,923,803,120,482013339023,15000US482013339023,482013339023,50964
667,667,48,201,334001,1,1409,547,1409,567,842,807,150,607,0,45,0,5,35,938,360,578,556,123,392,0,37,0,4,22,547,505,42,482013340011,15000US482013340011,482013340011,35293
668,668,48,201,334001,2,1769,609,1769,872,897,873,397,342,3,128,0,3,24,1216,545,671,652,344,203,3,100,0,2,19,609,576,33,482013340012,15000US482013340012,482013340012,54188
669,669,48,201,334002,1,636,364,636,217,419,406,244,120,1,38,2,1,13,523,161,362,352,228,92,1,29,1,1,10,364,321,43,482013340021,15000US482013340021,482013340021,71474
670,670,48,201,334002,2,1453,807,1453,513,940,921,381,411,1,124,3,1,19,1158,386,772,763,340,317,1,103,1,1,9,807,717,90,482013340022,15000US482013340022,482013340022,37775
671,671,48,201,334003,1,1876,658,1876,904,972,960,694,160,1,97,1,7,12,1437,616,821,815,603,121,1,84,1,5,6,658,632,26,482013340031,15000US482013340031,482013340031,54931
672,672,48,201,334003,2,1186,579,1186,519,667,653,205,358,2,85,1,2,14,870,350,520,511,181,261,2,64,1,2,9,579,533,46,482013340032,15000US482013340032,482013340032,42016
673,673,48,201,334003,3,2866,1109,2866,1376,1490,1452,895,335,2,210,1,9,38,2072,887,1185,1169,767,236,1,159,1,5,16,1109,977,132,482013340033,15000US482013340033,482013340033,50491
674,674,48,201,334100,1,1147,368,1147,369,778,772,24,741,1,6,0,0,6,837,227,610,607,22,578,1,6,0,0,3,368,351,17,482013341001,15000US482013341001,482013341001,52500
675,675,48,201,334100,2,6286,3099,6286,1550,4736,4661,808,3195,13,635,3,7,75,4627,1048,3579,3517,728,2234,11,535,3,6,62,3099,2733,366,482013341002,15000US482013341002,482013341002,43049
676,676,48,201,334100,3,1141,355,1141,464,677,670,38,624,3,3,0,2,7,871,306,565,558,37,515,3,3,0,0,7,355,339,16,482013341003,15000US482013341003,482013341003,46976
677,677,48,201,334100,4,1340,493,1340,216,1124,1120,16,1085,9,9,0,1,4,1020,128,892,889,15,862,5,6,0,1,3,493,474,19,482013341004,15000US482013341004,482013341004,63167
678,678,48,201,340100,1,3015,1154,3015,1273,1742,1697,990,429,4,267,1,6,45,2108,813,1295,1269,773,281,3,207,1,4,26,1154,1090,64,482013401001,15000US482013401001,482013401001,52974
679,679,48,201,340100,2,1603,952,1603,431,1172,1138,546,425,3,162,1,1,34,1223,317,906,888,471,277,2,136,1,1,18,952,828,124,482013401002,15000US482013401002,482013401002,33689
680,680,48,201,340201,1,397,362,397,50,347,334,215,6,0,113,0,0,13,288,30,258,249,167,5,0,77,0,0,9,362,144,218,482013402011,15000US482013402011,482013402011,112171
681,681,48,201,340201,2,1256,502,1256,139,1117,1071,686,36,2,346,0,1,46,899,97,802,781,516,28,2,234,0,1,21,502,471,31,482013402012,15000US482013402012,482013402012,112692
682,682,48,201,340202,1,2263,649,2263,158,2105,2062,1220,60,3,771,0,8,43,1473,100,1373,1351,811,34,1,503,0,2,22,649,646,3,482013402021,15000US482013402021,482013402021,131875
683,683,48,201,340202,2,2314,752,2314,249,2065,2010,1400,79,10,517,0,4,55,1631,165,1466,1444,1004,55,8,376,0,1,22,752,735,17,482013402022,15000US482013402022,482013402022,121786
684,684,48,201,340203,1,0,0,0,0,0,0,0,0,0,0,0,0,0,0,0,0,0,0,0,0,0,0,0,0,0,0,0,482013402031,15000US482013402031,482013402031,165865
685,685,48,201,340301,1,1688,593,1688,117,1571,1546,1215,49,0,281,0,1,25,1264,76,1188,1175,926,38,0,210,0,1,13,593,584,9,482013403011,15000US482013403011,482013403011,242500
686,686,48,201,340301,2,2590,848,2590,205,2385,2335,1730,43,4,558,0,0,50,1860,126,1734,1710,1264,34,2,410,0,0,24,848,832,16,482013403012,15000US482013403012,482013403012,187200
687,687,48,201,340302,1,2872,1064,2872,246,2626,2577,2320,71,10,172,0,4,49,2178,160,2018,1993,1787,53,5,145,0,3,25,1064,1044,20,482013403021,15000US482013403021,482013403021,120729
688,688,48,201,340302,2,1930,649,1930,147,1783,1745,1359,41,4,325,1,15,38,1355,93,1262,1245,970,29,4,234,1,7,17,649,640,9,482013403022,15000US482013403022,482013403022,97794
689,689,48,201,340302,3,2012,774,2012,264,1748,1718,1424,83,11,199,0,1,30,1533,168,1365,1355,1129,56,9,160,0,1,10,774,747,27,482013403023,15000US482013403023,482013403023,123480
690,690,48,201,340400,1,1358,537,1358,95,1263,1235,1066,31,3,133,0,2,28,1092,68,1024,1008,877,26,2,103,0,0,16,537,530,7,482013404001,15000US482013404001,482013404001,154375
691,691,48,201,340500,1,976,496,976,497,479,470,323,103,2,41,1,0,9,738,334,404,397,283,74,1,38,1,0,7,496,424,72,482013405001,15000US482013405001,482013405001,26313
692,692,48,201,340500,2,1477,788,1477,625,852,831,581,149,3,90,7,1,21,1082,396,686,679,499,102,3,69,5,1,7,788,602,186,482013405002,15000US482013405002,482013405002,31083
693,693,48,201,340500,3,2016,1096,2016,383,1633,1580,1196,140,2,239,0,3,53,1633,256,1377,1335,1020,114,2,196,0,3,42,1096,1000,96,482013405003,15000US482013405003,482013405003,51644
694,694,48,201,340500,4,1110,426,1110,145,965,943,865,41,2,35,0,0,22,881,101,780,767,711,23,2,31,0,0,13,426,417,9,482013405004,15000US482013405004,482013405004,95054
695,695,48,201,340500,5,788,300,788,118,670,658,595,33,1,28,1,0,12,622,87,535,526,478,26,1,20,1,0,9,300,293,7,482013405005,15000US482013405005,482013405005,89531
696,696,48,201,340600,1,1501,606,1501,152,1349,1327,1207,32,3,84,0,1,22,1211,91,1120,1111,1007,27,3,73,0,1,9,606,594,12,482013406001,15000US482013406001,482013406001,82266
697,697,48,201,340600,2,1010,382,1010,121,889,885,814,35,4,31,0,1,4,776,83,693,690,628,32,4,26,0,0,3,382,377,5,482013406002,15000US482013406002,482013406002,87321
698,698,48,201,340700,1,1789,686,1789,297,1492,1455,1028,130,7,286,1,3,37,1308,192,1116,1097,784,100,5,206,1,1,19,686,650,36,482013407001,15000US482013407001,482013407001,64732
699,699,48,201,340700,2,1840,713,1840,378,1462,1411,1188,115,17,78,1,12,51,1389,246,1143,1119,972,69,9,61,1,7,24,713,693,20,482013407002,15000US482013407002,482013407002,84909
700,700,48,201,340700,3,2317,857,2317,554,1763,1729,913,120,10,675,8,3,34,1644,335,1309,1290,742,78,5,457,7,1,19,857,801,56,482013407003,15000US482013407003,482013407003,42837
701,701,48,201,340700,4,1221,444,1221,204,1017,971,761,74,0,134,2,0,46,909,130,779,755,590,52,0,111,2,0,24,444,439,5,482013407004,15000US482013407004,482013407004,79655
702,702,48,201,340800,1,1959,669,1959,217,1742,1705,1293,65,6,338,1,2,37,1483,155,1328,1307,963,58,5,280,1,0,21,669,657,12,482013408001,15000US482013408001,482013408001,117829
703,703,48,201,340800,2,1602,589,1602,197,1405,1357,1099,52,3,194,0,9,48,1173,137,1036,1016,820,39,3,150,0,4,20,589,572,17,482013408002,15000US482013408002,482013408002,102083
704,704,48,201,340800,3,2173,800,2173,300,1873,1824,1357,128,5,324,4,6,49,1578,181,1397,1374,1036,90,4,242,1,1,23,800,783,17,482013408003,15000US482013408003,482013408003,110027
705,705,48,201,340900,1,1591,709,1591,452,1139,1092,713,228,3,143,1,4,47,1139,283,856,825,548,168,1,105,1,2,31,709,608,101,482013409001,15000US482013409001,482013409001,43995
706,706,48,201,340900,2,2625,1455,2625,768,1857,1796,1116,359,8,300,5,8,61,2083,546,1537,1499,976,289,6,220,3,5,38,1455,1354,101,482013409002,15000US482013409002,482013409002,33750
707,707,48,201,341000,1,1601,857,1601,345,1256,1211,923,172,6,108,0,2,45,1306,253,1053,1023,787,142,5,87,0,2,30,857,801,56,482013410001,15000US482013410001,482013410001,52284
708,708,48,201,341000,2,1406,636,1406,326,1080,1055,816,161,2,71,0,5,25,1071,216,855,842,659,119,2,58,0,4,13,636,597,39,482013410002,15000US482013410002,482013410002,64632
709,709,48,201,341000,3,2362,1278,2362,588,1774,1713,1132,374,4,196,2,5,61,1867,417,1450,1410,966,280,3,156,2,3,40,1278,1186,92,482013410003,15000US482013410003,482013410003,47169
710,710,48,201,341000,4,390,150,390,85,305,297,230,38,1,25,0,3,8,276,52,224,217,175,21,1,19,0,1,7,150,149,1,482013410004,15000US482013410004,482013410004,34484
711,711,48,201,341100,1,0,0,0,0,0,0,0,0,0,0,0,0,0,0,0,0,0,0,0,0,0,0,0,0,0,0,0,482013411001,15000US482013411001,482013411001,44275
712,712,48,201,341301,1,930,476,930,142,788,763,350,68,8,336,1,0,25,780,93,687,666,295,60,4,306,1,0,21,476,439,37,482013413011,15000US482013413011,482013413011,52760
713,713,48,201,341301,2,1398,875,1398,104,1294,1281,1162,54,6,56,1,2,13,1270,77,1193,1184,1089,47,6,40,1,1,9,875,847,28,482013413012,15000US482013413012,482013413012,68321
714,714,48,201,341301,3,1819,1111,1819,479,1340,1304,789,210,9,295,0,1,36,1508,337,1171,1146,713,171,9,252,0,1,25,1111,987,124,482013413013,15000US482013413013,482013413013,29583
715,715,48,201,341302,1,941,529,941,276,665,647,419,125,1,102,0,0,18,757,195,562,548,356,98,1,93,0,0,14,529,478,51,482013413021,15000US482013413021,482013413021,53447
716,716,48,201,341302,2,1471,831,1471,297,1174,1130,726,109,9,279,3,4,44,1187,210,977,942,637,82,5,214,2,2,35,831,745,86,482013413022,15000US482013413022,482013413022,46983
717,717,48,201,343600,1,3,1,3,0,3,3,0,3,0,0,0,0,0,3,0,3,3,0,3,0,0,0,0,0,1,1,0,482013436001,15000US482013436001,482013436001,73095
718,718,48,201,350100,1,8,2,8,0,8,8,0,2,0,6,0,0,0,8,0,8,8,0,2,0,6,0,0,0,2,2,0,482013501001,15000US482013501001,482013501001,83934
719,719,48,201,350100,2,799,265,799,123,676,660,38,604,0,14,1,3,16,431,69,362,359,31,312,0,14,0,2,3,265,247,18,482013501002,15000US482013501002,482013501002,77768
720,720,48,201,350200,1,765,228,765,447,318,306,188,65,9,44,0,0,12,520,274,246,240,152,46,8,34,0,0,6,228,215,13,482013502001,15000US482013502001,482013502001,37620
721,721,48,201,350200,3,2010,631,2010,1028,982,971,707,191,3,59,1,10,11,1448,678,770,763,575,134,1,47,1,5,7,631,598,33,482013502003,15000US482013502003,482013502003,57574
722,722,48,201,350200,4,0,0,0,0,0,0,0,0,0,0,0,0,0,0,0,0,0,0,0,0,0,0,0,0,0,0,0,482013502004,15000US482013502004,482013502004,82520
723,723,48,201,350300,1,1022,389,1022,393,629,621,431,135,4,48,0,3,8,785,257,528,525,373,105,4,40,0,3,3,389,367,22,482013503001,15000US482013503001,482013503001,58167
724,724,48,201,350300,2,126,43,126,40,86,86,73,12,0,1,0,0,0,90,22,68,68,59,8,0,1,0,0,0,43,43,0,482013503002,15000US482013503002,482013503002,101000
725,725,48,201,350300,4,82,29,82,32,50,50,34,5,0,9,0,2,0,64,22,42,42,28,5,0,7,0,2,0,29,27,2,482013503004,15000US482013503004,482013503004,76350
726,726,48,201,350400,1,923,292,923,456,467,459,374,70,1,12,0,2,8,641,282,359,356,294,50,1,9,0,2,3,292,281,11,482013504001,15000US482013504001,482013504001,64518
727,727,48,201,350400,2,212,77,212,100,112,105,75,19,0,11,0,0,7,156,66,90,86,63,15,0,8,0,0,4,77,67,10,482013504002,15000US482013504002,482013504002,65287
728,728,48,201,350400,3,478,160,478,247,231,226,169,42,0,15,0,0,5,353,161,192,188,150,25,0,13,0,0,4,160,155,5,482013504003,15000US482013504003,482013504003,33348
729,729,48,201,350500,1,739,237,739,381,358,347,193,77,1,75,0,1,11,545,243,302,294,176,53,1,63,0,1,8,237,233,4,482013505001,15000US482013505001,482013505001,39344
730,730,48,201,350500,2,1279,557,1279,688,591,565,182,246,8,128,1,0,26,883,430,453,438,146,187,3,101,1,0,15,557,467,90,482013505002,15000US482013505002,482013505002,28608
731,731,48,201,350500,3,2842,956,2842,1163,1679,1635,798,333,2,495,3,4,44,1974,739,1235,1213,615,232,2,361,1,2,22,956,934,22,482013505003,15000US482013505003,482013505003,51852
732,732,48,201,350500,4,1607,486,1607,1068,539,531,257,176,6,85,0,7,8,1122,684,438,434,216,132,4,75,0,7,4,486,465,21,482013505004,15000US482013505004,482013505004,54188
733,733,48,201,350601,1,591,322,591,166,425,406,306,58,0,42,0,0,19,474,121,353,342,259,48,0,35,0,0,11,322,300,22,482013506011,15000US482013506011,482013506011,60650
734,734,48,201,350802,1,3,1,3,0,3,3,3,0,0,0,0,0,0,2,0,2,2,2,0,0,0,0,0,0,1,1,0,482013508021,15000US482013508021,482013508021,94208
735,735,48,201,410100,1,2535,1520,2535,371,2164,2113,881,976,11,240,1,4,51,2061,299,1762,1727,862,624,11,225,1,4,35,1520,1405,115,482014101001,15000US482014101001,482014101001,39167
736,736,48,201,410100,2,1258,606,1258,338,920,887,394,427,2,60,0,4,33,972,246,726,705,378,266,2,57,0,2,21,606,567,39,482014101002,15000US482014101002,482014101002,57841
737,737,48,201,410200,1,1551,1065,1551,218,1333,1295,1175,44,3,72,1,0,38,1470,197,1273,1243,1132,41,3,66,1,0,30,1065,961,104,482014102001,15000US482014102001,482014102001,94760
738,738,48,201,410200,2,959,626,959,187,772,756,683,23,1,44,0,5,16,882,158,724,713,644,20,1,43,0,5,11,626,554,72,482014102002,15000US482014102002,482014102002,68750
739,739,48,201,410200,3,1692,1187,1692,369,1323,1292,1084,69,9,129,1,0,31,1588,312,1276,1252,1057,66,8,120,1,0,24,1187,1044,143,482014102003,15000US482014102003,482014102003,54811
740,740,48,201,410300,1,156,18,156,8,148,148,125,20,0,3,0,0,0,155,7,148,148,125,20,0,3,0,0,0,18,18,0,482014103001,15000US482014103001,482014103001,39531
741,741,48,201,410300,2,786,479,786,94,692,685,611,16,3,55,0,0,7,710,84,626,620,556,12,3,49,0,0,6,479,445,34,482014103002,15000US482014103002,482014103002,103750
742,742,48,201,410300,3,1679,1211,1679,277,1402,1369,1118,110,1,129,0,11,33,1539,229,1310,1285,1066,92,1,116,0,10,25,1211,1050,161,482014103003,15000US482014103003,482014103003,61750
743,743,48,201,410401,1,1810,1116,1810,304,1506,1489,1347,31,2,100,2,7,17,1621,236,1385,1373,1251,30,2,84,2,4,12,1116,1046,70,482014104011,15000US482014104011,482014104011,78750
744,744,48,201,410401,2,1005,629,1005,200,805,780,708,30,1,38,0,3,25,891,159,732,714,645,27,1,38,0,3,18,629,558,71,482014104012,15000US482014104012,482014104012,82083
745,745,48,201,410401,3,992,652,992,168,824,806,726,28,3,44,0,5,18,908,147,761,745,671,25,3,42,0,4,16,652,589,63,482014104013,15000US482014104013,482014104013,90268
746,746,48,201,410402,1,1006,653,1006,255,751,733,623,34,0,73,0,3,18,888,191,697,689,586,33,0,69,0,1,8,653,585,68,482014104021,15000US482014104021,482014104021,30243
747,747,48,201,410402,2,1550,918,1550,418,1132,1100,959,52,2,81,0,6,32,1361,321,1040,1022,890,46,2,79,0,5,18,918,833,85,482014104022,15000US482014104022,482014104022,71667
748,748,48,201,410500,1,1582,1182,1582,304,1278,1248,1087,46,1,110,0,4,30,1487,263,1224,1201,1056,43,1,97,0,4,23,1182,998,184,482014105001,15000US482014105001,482014105001,83125
749,749,48,201,410500,2,1025,694,1025,192,833,817,725,39,3,48,0,2,16,967,174,793,781,695,36,3,45,0,2,12,694,613,81,482014105002,15000US482014105002,482014105002,73000
750,750,48,201,410500,3,590,399,590,101,489,478,417,16,4,39,0,2,11,554,93,461,453,394,16,4,37,0,2,8,399,348,51,482014105003,15000US482014105003,482014105003,36270
751,751,48,201,410500,4,1012,645,1012,143,869,849,767,24,0,57,0,1,20,932,126,806,797,721,24,0,51,0,1,9,645,579,66,482014105004,15000US482014105004,482014105004,75903
752,752,48,201,410600,1,1262,1171,1262,190,1072,1046,872,73,2,94,1,4,26,1189,134,1055,1030,865,66,2,93,1,3,25,1171,851,320,482014106001,15000US482014106001,482014106001,85655
753,753,48,201,410600,2,1944,1529,1944,245,1699,1661,1433,111,8,98,2,9,38,1902,232,1670,1634,1414,106,8,95,2,9,36,1529,1355,174,482014106002,15000US482014106002,482014106002,76219
754,754,48,201,410701,1,844,576,844,126,718,709,595,85,0,26,0,3,9,801,114,687,678,567,83,0,25,0,3,9,576,508,68,482014107011,15000US482014107011,482014107011,60163
755,755,48,201,410701,2,852,593,852,109,743,730,671,15,3,38,2,1,13,796,99,697,687,631,15,3,35,2,1,10,593,532,61,482014107012,15000US482014107012,482014107012,54844
756,756,48,201,410701,3,1122,868,1122,195,927,907,786,82,2,33,0,4,20,1063,172,891,875,759,77,2,33,0,4,16,868,778,90,482014107013,15000US482014107013,482014107013,38942
757,757,48,201,410701,4,822,580,822,142,680,668,595,38,1,32,1,1,12,753,121,632,622,553,36,0,31,1,1,10,580,478,102,482014107014,15000US482014107014,482014107014,32328
758,758,48,201,410702,1,1163,1019,1163,154,1009,993,793,142,3,54,0,1,16,1110,130,980,965,770,141,3,50,0,1,15,1019,830,189,482014107021,15000US482014107021,482014107021,56250
759,759,48,201,410702,2,1459,763,1459,400,1059,1025,770,50,1,197,2,5,34,1350,335,1015,984,737,50,1,190,2,4,31,763,676,87,482014107022,15000US482014107022,482014107022,35057
760,760,48,201,410800,1,1036,705,1036,152,884,866,797,19,0,47,1,2,18,922,133,789,778,720,19,0,38,1,0,11,705,614,91,482014108001,15000US482014108001,482014108001,55781
761,761,48,201,410800,2,1696,1188,1696,519,1177,1144,993,61,3,83,2,2,33,1506,392,1114,1088,944,57,3,80,2,2,26,1188,1049,139,482014108002,15000US482014108002,482014108002,32367
762,762,48,201,410800,3,1086,682,1086,313,773,745,666,29,1,48,1,0,28,934,247,687,665,596,26,1,41,1,0,22,682,604,78,482014108003,15000US482014108003,482014108003,35086
763,763,48,201,410900,1,1132,827,1132,208,924,896,775,59,0,58,1,3,28,1032,170,862,838,725,54,0,55,1,3,24,827,726,101,482014109001,15000US482014109001,482014109001,43068
764,764,48,201,410900,2,826,531,826,160,666,660,581,36,0,41,0,2,6,744,132,612,608,538,31,0,37,0,2,4,531,489,42,482014109002,15000US482014109002,482014109002,53226
765,765,48,201,410900,3,726,451,726,146,580,571,489,32,3,47,0,0,9,645,119,526,523,454,28,1,40,0,0,3,451,400,51,482014109003,15000US482014109003,482014109003,91250
766,766,48,201,411000,1,1405,1197,1405,155,1250,1240,1109,45,2,84,0,0,10,1313,138,1175,1166,1043,40,2,81,0,0,9,1197,937,260,482014110001,15000US482014110001,482014110001,81571
767,767,48,201,411000,2,1398,1188,1398,152,1246,1222,1038,45,3,132,2,2,24,1326,144,1182,1162,1000,38,3,118,2,1,20,1188,927,261,482014110002,15000US482014110002,482014110002,74342
768,768,48,201,411000,3,1359,960,1359,155,1204,1184,1012,45,3,122,0,2,20,1244,138,1106,1089,929,42,3,113,0,2,17,960,853,107,482014110003,15000US482014110003,482014110003,90804
769,769,48,201,411100,1,1402,591,1402,53,1349,1335,1262,22,1,45,0,5,14,1025,42,983,978,922,19,1,35,0,1,5,591,519,72,482014111001,15000US482014111001,482014111001,250001
770,770,48,201,411100,2,926,634,926,119,807,796,702,33,3,58,0,0,11,820,90,730,728,655,26,3,44,0,0,2,634,558,76,482014111002,15000US482014111002,482014111002,84464
771,771,48,201,411100,3,1122,550,1122,171,951,943,790,46,1,103,0,3,8,887,123,764,760,655,32,1,71,0,1,4,550,521,29,482014111003,15000US482014111003,482014111003,92283
772,772,48,201,411200,1,1086,495,1086,73,1013,1004,934,13,2,53,0,2,9,854,61,793,789,733,10,2,42,0,2,4,495,452,43,482014112001,15000US482014112001,482014112001,250001
773,773,48,201,411200,2,717,275,717,26,691,685,663,1,0,21,0,0,6,559,20,539,533,517,1,0,15,0,0,6,275,263,12,482014112002,15000US482014112002,482014112002,250001
774,774,48,201,411300,1,1497,1086,1497,162,1335,1327,1156,50,5,113,1,2,8,1399,143,1256,1250,1098,38,5,107,1,1,6,1086,915,171,482014113001,15000US482014113001,482014113001,87446
775,775,48,201,411300,2,1198,1043,1198,249,949,932,697,125,0,108,1,1,17,1125,219,906,890,685,106,0,97,1,1,16,1043,865,178,482014113002,15000US482014113002,482014113002,44952
776,776,48,201,411300,3,688,560,688,147,541,525,377,66,3,77,1,1,16,654,138,516,503,362,63,3,73,1,1,13,560,488,72,482014113003,15000US482014113003,482014113003,50536
777,777,48,201,411400,1,1372,762,1372,55,1317,1314,1261,22,0,30,0,1,3,1125,41,1084,1083,1045,16,0,21,0,1,1,762,679,83,482014114001,15000US482014114001,482014114001,133000
778,778,48,201,411400,2,772,292,772,38,734,729,702,6,0,21,0,0,5,576,31,545,544,527,4,0,13,0,0,1,292,277,15,482014114002,15000US482014114002,482014114002,250001
779,779,48,201,411400,3,631,263,631,15,616,614,588,6,1,19,0,0,2,482,12,470,469,449,3,1,16,0,0,1,263,244,19,482014114003,15000US482014114003,482014114003,250001
780,780,48,201,411501,1,2105,1591,2105,337,1768,1731,1342,152,3,227,3,4,37,1969,300,1669,1640,1277,137,3,217,2,4,29,1591,1391,200,482014115011,15000US482014115011,482014115011,65938
781,781,48,201,411501,2,1748,1671,1748,219,1529,1507,1271,75,2,157,2,0,22,1539,184,1355,1335,1122,63,2,146,2,0,20,1671,1024,647,482014115012,15000US482014115012,482014115012,102163
782,782,48,201,411501,3,1380,937,1380,164,1216,1189,1022,44,0,120,0,3,27,1273,145,1128,1105,948,43,0,112,0,2,23,937,857,80,482014115013,15000US482014115013,482014115013,66923
783,783,48,201,411502,1,1284,874,1284,146,1138,1117,911,58,3,144,0,1,21,1147,124,1023,1008,834,45,3,125,0,1,15,874,789,85,482014115021,15000US482014115021,482014115021,97222
784,784,48,201,411502,2,706,585,706,80,626,619,528,28,0,62,0,1,7,670,72,598,591,506,25,0,59,0,1,7,585,496,89,482014115022,15000US482014115022,482014115022,78804
785,785,48,201,411502,3,722,567,722,127,595,580,455,37,3,76,2,7,15,677,113,564,550,432,36,3,70,2,7,14,567,512,55,482014115023,15000US482014115023,482014115023,52188
786,786,48,201,411502,4,1204,865,1204,166,1038,1022,805,70,1,146,0,0,16,1135,156,979,965,764,63,1,137,0,0,14,865,794,71,482014115024,15000US482014115024,482014115024,56834
787,787,48,201,411600,1,1256,641,1256,90,1166,1150,1090,13,6,40,1,0,16,1068,76,992,985,935,11,6,32,1,0,7,641,597,44,482014116001,15000US482014116001,482014116001,160833
788,788,48,201,411600,2,1051,639,1051,91,960,941,859,44,0,38,0,0,19,861,80,781,768,696,40,0,32,0,0,13,639,532,107,482014116002,15000US482014116002,482014116002,81111
789,789,48,201,411700,1,770,616,770,164,606,598,446,68,2,82,0,0,8,714,140,574,566,425,63,2,76,0,0,8,616,529,87,482014117001,15000US482014117001,482014117001,31728
790,790,48,201,411700,2,2004,1433,2004,304,1700,1662,1189,177,3,291,1,1,38,1887,275,1612,1578,1140,170,3,263,1,1,34,1433,1364,69,482014117002,15000US482014117002,482014117002,68182
791,791,48,201,411800,1,1068,933,1068,136,932,916,748,38,2,125,0,3,16,1011,121,890,876,735,34,2,102,0,3,14,933,813,120,482014118001,15000US482014118001,482014118001,33790
792,792,48,201,411800,2,1282,769,1282,138,1144,1119,833,42,2,239,0,3,25,1039,104,935,917,689,35,2,189,0,2,18,769,694,75,482014118002,15000US482014118002,482014118002,96435
793,793,48,201,411800,3,1496,905,1496,177,1319,1288,1065,40,2,179,2,0,31,1240,141,1099,1083,912,33,2,136,0,0,16,905,813,92,482014118003,15000US482014118003,482014118003,82222
794,794,48,201,411800,4,989,589,989,88,901,881,708,33,5,126,0,9,20,832,69,763,751,611,28,3,103,0,6,12,589,532,57,482014118004,15000US482014118004,482014118004,105341
795,795,48,201,411900,1,699,435,699,107,592,588,555,11,3,19,0,0,4,589,62,527,523,494,11,3,15,0,0,4,435,371,64,482014119001,15000US482014119001,482014119001,111469
796,796,48,201,411900,2,1384,725,1384,121,1263,1246,1181,13,2,44,0,6,17,1121,91,1030,1021,970,10,2,36,0,3,9,725,655,70,482014119002,15000US482014119002,482014119002,108203
797,797,48,201,411900,3,1598,1138,1598,134,1464,1422,1200,53,4,161,2,2,42,1471,118,1353,1320,1109,48,4,157,2,0,33,1138,1025,113,482014119003,15000US482014119003,482014119003,65000
798,798,48,201,412000,1,1168,584,1168,79,1089,1063,952,28,0,82,0,1,26,946,51,895,876,786,17,0,73,0,0,19,584,528,56,482014120001,15000US482014120001,482014120001,174079
799,799,48,201,412000,2,893,506,893,68,825,802,694,5,9,91,0,3,23,736,60,676,663,578,5,7,72,0,1,13,506,443,63,482014120002,15000US482014120002,482014120002,112039
800,800,48,201,412000,3,831,359,831,32,799,792,745,11,0,34,0,2,7,639,19,620,618,583,7,0,26,0,2,2,359,335,24,482014120003,15000US482014120003,482014120003,215889
801,801,48,201,412100,1,2328,4,2328,305,2023,1979,1006,110,0,858,4,1,44,2322,305,2017,1974,1005,109,0,855,4,1,43,4,4,0,482014121001,15000US482014121001,482014121001,
802,802,48,201,412200,1,696,284,696,33,663,654,605,13,0,36,0,0,9,516,29,487,483,451,9,0,23,0,0,4,284,265,19,482014122001,15000US482014122001,482014122001,250001
803,803,48,201,412200,2,991,454,991,40,951,930,860,19,1,46,0,4,21,749,32,717,705,649,17,1,37,0,1,12,454,409,45,482014122002,15000US482014122002,482014122002,176364
804,804,48,201,412200,3,1495,833,1495,175,1320,1280,902,62,0,314,0,2,40,1214,131,1083,1065,772,49,0,243,0,1,18,833,728,105,482014122003,15000US482014122003,482014122003,63784
805,805,48,201,412200,4,2173,944,2173,201,1972,1921,1553,36,4,319,0,9,51,1727,159,1568,1540,1236,32,4,263,0,5,28,944,869,75,482014122004,15000US482014122004,482014122004,130673
806,806,48,201,412600,1,7,2,7,0,7,5,4,0,0,1,0,0,2,4,0,4,4,3,0,0,1,0,0,0,2,2,0,482014126001,15000US482014126001,482014126001,192232
807,807,48,201,412600,2,11,3,11,0,11,7,7,0,0,0,0,0,4,8,0,8,4,4,0,0,0,0,0,4,3,3,0,482014126002,15000US482014126002,482014126002,126957
808,808,48,201,412600,3,0,0,0,0,0,0,0,0,0,0,0,0,0,0,0,0,0,0,0,0,0,0,0,0,0,0,0,482014126003,15000US482014126003,482014126003,208077
809,809,48,201,412700,1,0,0,0,0,0,0,0,0,0,0,0,0,0,0,0,0,0,0,0,0,0,0,0,0,0,0,0,482014127001,15000US482014127001,482014127001,110833
810,810,48,201,412700,2,12,6,12,0,12,9,9,0,0,0,0,0,3,8,0,8,6,6,0,0,0,0,0,2,6,4,2,482014127002,15000US482014127002,482014127002,115820
811,811,48,201,412800,1,19,7,19,6,13,13,12,1,0,0,0,0,0,11,4,7,7,6,1,0,0,0,0,0,7,6,1,482014128001,15000US482014128001,482014128001,170114
812,812,48,201,412800,2,28,9,28,2,26,26,20,0,0,6,0,0,0,17,1,16,16,11,0,0,5,0,0,0,9,9,0,482014128002,15000US482014128002,482014128002,210511
813,813,48,201,412800,3,6,4,6,0,6,6,6,0,0,0,0,0,0,5,0,5,5,5,0,0,0,0,0,0,4,4,0,482014128003,15000US482014128003,482014128003,99891
814,814,48,201,412900,1,1269,912,1269,187,1082,1033,582,248,4,193,3,3,49,1113,155,958,922,534,214,4,164,3,3,36,912,770,142,482014129001,15000US482014129001,482014129001,57941
815,815,48,201,412900,2,1700,982,1700,218,1482,1446,895,197,3,346,0,5,36,1397,168,1229,1205,745,166,3,287,0,4,24,982,841,141,482014129002,15000US482014129002,482014129002,42813
816,816,48,201,412900,3,923,444,923,89,834,818,491,128,0,196,1,2,16,781,62,719,713,443,107,0,160,1,2,6,444,423,21,482014129003,15000US482014129003,482014129003,75938
817,817,48,201,413000,1,1813,693,1813,216,1597,1561,1267,86,1,200,4,3,36,1252,135,1117,1109,909,56,1,138,4,1,8,693,648,45,482014130001,15000US482014130001,482014130001,141071
818,818,48,201,413000,2,1647,1023,1647,327,1320,1292,974,79,12,220,1,6,28,1318,240,1078,1063,795,68,10,183,1,6,15,1023,806,217,482014130002,15000US482014130002,482014130002,67083
819,819,48,201,413100,1,1160,497,1160,106,1054,1029,859,30,0,135,0,5,25,868,70,798,782,653,25,0,102,0,2,16,497,450,47,482014131001,15000US482014131001,482014131001,121591
820,820,48,201,413100,2,945,335,945,91,854,832,776,9,3,44,0,0,22,634,49,585,577,532,9,3,33,0,0,8,335,317,18,482014131002,15000US482014131002,482014131002,135125
821,821,48,201,413100,3,982,350,982,87,895,852,754,32,1,64,0,1,43,642,43,599,581,511,23,1,45,0,1,18,350,329,21,482014131003,15000US482014131003,482014131003,148750
822,822,48,201,413201,1,1110,829,1110,157,953,938,579,94,2,262,0,1,15,997,130,867,852,533,87,2,229,0,1,15,829,695,134,482014132011,15000US482014132011,482014132011,39464
823,823,48,201,413201,2,1516,1043,1516,203,1313,1273,929,67,1,271,0,5,40,1381,174,1207,1173,871,62,1,238,0,1,34,1043,857,186,482014132012,15000US482014132012,482014132012,91071
824,824,48,201,413202,1,924,723,924,149,775,749,546,29,1,171,0,2,26,849,137,712,694,522,28,1,141,0,2,18,723,606,117,482014132021,15000US482014132021,482014132021,60294
825,825,48,201,413202,2,1954,1458,1954,305,1649,1610,1040,159,4,401,1,5,39,1775,268,1507,1471,992,136,4,333,1,5,36,1458,1223,235,482014132022,15000US482014132022,482014132022,50833
826,826,48,201,413300,1,1716,1066,1716,232,1484,1443,782,279,3,377,1,1,41,1485,200,1285,1254,700,233,3,317,1,0,31,1066,950,116,482014133001,15000US482014133001,482014133001,29226
827,827,48,201,413300,2,1917,1052,1917,240,1677,1644,899,488,3,247,0,7,33,1549,184,1365,1341,745,399,3,189,0,5,24,1052,924,128,482014133002,15000US482014133002,482014133002,105521
828,828,48,201,413300,3,1287,586,1287,187,1100,1084,829,65,4,180,6,0,16,1018,140,878,871,672,42,4,149,4,0,7,586,548,38,482014133003,15000US482014133003,482014133003,95815
829,829,48,201,413300,4,1048,487,1048,150,898,872,646,65,0,161,0,0,26,774,96,678,668,488,58,0,122,0,0,10,487,442,45,482014133004,15000US482014133004,482014133004,72708
830,830,48,201,413300,5,929,404,929,92,837,818,634,45,4,134,0,1,19,716,61,655,641,500,35,4,101,0,1,14,404,379,25,482014133005,15000US482014133005,482014133005,141094
831,831,48,201,420100,1,1895,882,1895,870,1025,1002,329,369,3,291,4,6,23,1432,571,861,847,285,314,3,239,4,2,14,882,801,81,482014201001,15000US482014201001,482014201001,29083
832,832,48,201,420100,2,1167,659,1167,381,786,771,65,671,2,33,0,0,15,907,272,635,625,60,532,2,31,0,0,10,659,587,72,482014201002,15000US482014201002,482014201002,25094
833,833,48,201,420200,1,1372,579,1372,505,867,833,550,117,3,157,1,5,34,1098,365,733,709,478,94,2,131,1,3,24,579,537,42,482014202001,15000US482014202001,482014202001,44415
834,834,48,201,420200,2,1175,397,1175,686,489,453,232,102,1,114,0,4,36,847,445,402,381,204,77,1,97,0,2,21,397,381,16,482014202002,15000US482014202002,482014202002,59125
835,835,48,201,420300,1,1503,869,1503,219,1284,1252,649,517,2,79,1,4,32,1259,173,1086,1064,536,450,2,73,1,2,22,869,800,69,482014203001,15000US482014203001,482014203001,63114
836,836,48,201,420300,2,839,365,839,90,749,728,658,27,2,41,0,0,21,667,58,609,597,543,24,2,28,0,0,12,365,352,13,482014203002,15000US482014203002,482014203002,125938
837,837,48,201,420300,3,1069,453,1069,139,930,917,846,28,1,37,1,4,13,840,97,743,736,680,22,1,28,1,4,7,453,441,12,482014203003,15000US482014203003,482014203003,115500
838,838,48,201,420400,1,1084,508,1084,132,952,937,793,52,2,90,0,0,15,893,110,783,772,664,39,2,67,0,0,11,508,487,21,482014204001,15000US482014204001,482014204001,78553
839,839,48,201,420400,2,1453,698,1453,163,1290,1265,1111,63,2,88,0,1,25,1168,107,1061,1043,925,45,2,70,0,1,18,698,660,38,482014204002,15000US482014204002,482014204002,62500
840,840,48,201,420400,3,856,396,856,322,534,519,381,60,0,77,0,1,15,682,220,462,456,334,52,0,69,0,1,6,396,367,29,482014204003,15000US482014204003,482014204003,38125
841,841,48,201,420500,1,894,304,894,714,180,177,49,112,0,12,0,4,3,620,484,136,133,42,79,0,11,0,1,3,304,280,24,482014205001,15000US482014205001,482014205001,28417
842,842,48,201,420500,2,1848,571,1848,1388,460,456,60,384,2,10,0,0,4,1192,827,365,365,53,302,2,8,0,0,0,571,533,38,482014205002,15000US482014205002,482014205002,20532
843,843,48,201,420500,3,1299,564,1299,854,445,438,21,152,0,264,0,1,7,909,543,366,361,16,119,0,226,0,0,5,564,438,126,482014205003,15000US482014205003,482014205003,15804
844,844,48,201,420600,1,598,349,598,139,459,441,343,67,1,29,0,1,18,495,99,396,388,308,53,1,25,0,1,8,349,305,44,482014206001,15000US482014206001,482014206001,52137
845,845,48,201,420600,2,1634,670,1634,516,1118,1095,869,151,0,74,0,1,23,1226,322,904,889,727,98,0,63,0,1,15,670,635,35,482014206002,15000US482014206002,482014206002,90000
846,846,48,201,420700,1,903,342,903,73,830,811,704,19,0,82,0,6,19,675,51,624,615,540,10,0,61,0,4,9,342,326,16,482014207001,15000US482014207001,482014207001,158795
847,847,48,201,420700,2,590,248,590,46,544,543,493,13,0,37,0,0,1,482,30,452,452,419,7,0,26,0,0,0,248,244,4,482014207002,15000US482014207002,482014207002,178000
848,848,48,201,420700,3,1646,659,1646,156,1490,1470,1270,47,0,145,0,8,20,1248,109,1139,1131,978,34,0,114,0,5,8,659,634,25,482014207003,15000US482014207003,482014207003,100862
849,849,48,201,420800,1,803,321,803,74,729,715,588,28,3,96,0,0,14,630,58,572,568,464,20,3,81,0,0,4,321,304,17,482014208001,15000US482014208001,482014208001,100556
850,850,48,201,420800,2,853,341,853,72,781,768,620,2,0,145,0,1,13,677,50,627,622,512,2,0,107,0,1,5,341,331,10,482014208002,15000US482014208002,482014208002,151442
851,851,48,201,420800,3,856,338,856,48,808,798,646,5,5,142,0,0,10,672,33,639,635,520,3,3,109,0,0,4,338,330,8,482014208003,15000US482014208003,482014208003,165882
852,852,48,201,421101,1,758,504,758,159,599,589,382,94,1,112,0,0,10,688,144,544,535,350,89,1,95,0,0,9,504,472,32,482014211011,15000US482014211011,482014211011,65417
853,853,48,201,421101,2,2971,1231,2971,2117,854,830,213,436,2,179,0,0,24,2068,1370,698,677,178,344,2,153,0,0,21,1231,1162,69,482014211012,15000US482014211012,482014211012,26793
854,854,48,201,421102,1,2674,1205,2674,2392,282,272,83,170,3,11,0,5,10,1798,1573,225,218,57,143,3,11,0,4,7,1205,915,290,482014211021,15000US482014211021,482014211021,23787
855,855,48,201,421102,2,1345,736,1345,341,1004,982,113,496,3,362,0,8,22,1129,265,864,848,104,396,1,341,0,6,16,736,603,133,482014211022,15000US482014211022,482014211022,41970
856,856,48,201,421102,3,1525,360,1525,1460,65,65,26,25,0,11,0,3,0,913,866,47,47,19,17,0,11,0,0,0,360,319,41,482014211023,15000US482014211023,482014211023,26127
857,857,48,201,421201,1,2078,964,2078,1633,445,430,110,246,1,65,0,8,15,1581,1186,395,384,104,214,0,62,0,4,11,964,887,77,482014212011,15000US482014212011,482014212011,22727
858,858,48,201,421201,2,1777,740,1777,1329,448,445,54,307,0,83,0,1,3,1186,848,338,335,50,222,0,62,0,1,3,740,614,126,482014212012,15000US482014212012,482014212012,29185
859,859,48,201,421201,3,544,187,544,537,7,7,6,1,0,0,0,0,0,370,368,2,2,1,1,0,0,0,0,0,187,161,26,482014212013,15000US482014212013,482014212013,16314
860,860,48,201,421202,1,1665,694,1665,1389,276,264,41,179,0,44,0,0,12,1051,874,177,170,33,108,0,29,0,0,7,694,514,180,482014212021,15000US482014212021,482014212021,19923
861,861,48,201,421202,2,2005,761,2005,1929,76,75,26,36,1,7,0,5,1,1405,1351,54,53,19,26,1,5,0,2,1,761,605,156,482014212022,15000US482014212022,482014212022,18232
862,862,48,201,421202,3,475,228,475,394,81,76,11,58,0,7,0,0,5,334,273,61,56,11,38,0,7,0,0,5,228,174,54,482014212023,15000US482014212023,482014212023,30093
863,863,48,201,421300,1,2282,864,2282,538,1744,1628,403,321,3,896,0,5,116,1570,356,1214,1139,280,246,0,609,0,4,75,864,781,83,482014213001,15000US482014213001,482014213001,32900
864,864,48,201,421300,2,2631,1171,2631,2283,348,333,110,198,0,24,0,1,15,1910,1609,301,289,93,173,0,22,0,1,12,1171,984,187,482014213002,15000US482014213002,482014213002,28841
865,865,48,201,421300,3,1722,530,1722,931,791,759,204,211,5,335,0,4,32,1131,577,554,536,153,146,4,230,0,3,18,530,490,40,482014213003,15000US482014213003,482014213003,25662
866,866,48,201,421401,1,1390,605,1390,1256,134,131,35,77,1,16,0,2,3,882,788,94,92,29,50,0,12,0,1,2,605,418,187,482014214011,15000US482014214011,482014214011,20581
867,867,48,201,421401,2,2236,769,2236,1864,372,362,43,113,2,198,0,6,10,1576,1297,279,273,32,69,2,168,0,2,6,769,675,94,482014214012,15000US482014214012,482014214012,33649
868,868,48,201,421402,1,1879,656,1879,1798,81,79,32,39,0,6,0,2,2,1216,1164,52,52,15,33,0,4,0,0,0,656,524,132,482014214021,15000US482014214021,482014214021,24744
869,869,48,201,421402,2,1561,726,1561,1495,66,64,20,41,0,2,0,1,2,1005,949,56,55,17,35,0,2,0,1,1,726,493,233,482014214022,15000US482014214022,482014214022,20263
870,870,48,201,421403,1,1411,476,1411,1367,44,44,19,17,0,5,0,3,0,984,950,34,34,12,16,0,5,0,1,0,476,414,62,482014214031,15000US482014214031,482014214031,24804
871,871,48,201,421403,2,2153,612,2153,1682,471,451,83,200,0,166,0,2,20,1455,1129,326,309,59,116,0,133,0,1,17,612,570,42,482014214032,15000US482014214032,482014214032,22011
872,872,48,201,421403,3,799,251,799,636,163,162,114,26,0,22,0,0,1,588,441,147,146,108,20,0,18,0,0,1,251,242,9,482014214033,15000US482014214033,482014214033,32100
873,873,48,201,421500,1,1090,425,1090,590,500,490,134,272,3,78,0,3,10,734,380,354,347,97,175,3,70,0,2,7,425,370,55,482014215001,15000US482014215001,482014215001,27639
874,874,48,201,421500,2,2264,832,2264,1867,397,385,158,162,2,61,0,2,12,1573,1256,317,308,132,117,2,55,0,2,9,832,729,103,482014215002,15000US482014215002,482014215002,30455
875,875,48,201,421500,3,1345,597,1345,832,513,493,305,93,3,90,0,2,20,1006,547,459,444,277,86,3,76,0,2,15,597,532,65,482014215003,15000US482014215003,482014215003,33365
876,876,48,201,421500,4,1785,927,1785,483,1302,1275,239,705,1,324,0,6,27,1461,362,1099,1077,217,552,1,302,0,5,22,927,795,132,482014215004,15000US482014215004,482014215004,34849
877,877,48,201,421600,1,1778,561,1778,1560,218,215,65,136,1,11,0,2,3,1134,972,162,159,54,94,1,9,0,1,3,561,480,81,482014216001,15000US482014216001,482014216001,30365
878,878,48,201,421600,2,2158,653,2158,2030,128,119,40,36,0,38,0,5,9,1352,1253,99,94,36,28,0,26,0,4,5,653,574,79,482014216002,15000US482014216002,482014216002,22880
879,879,48,201,421600,3,1453,628,1453,626,827,815,437,36,1,341,0,0,12,1047,425,622,616,343,30,1,242,0,0,6,628,569,59,482014216003,15000US482014216003,482014216003,31417
880,880,48,201,421600,4,1625,513,1625,1488,137,135,34,78,3,7,0,13,2,1029,944,85,84,26,43,1,7,0,7,1,513,399,114,482014216004,15000US482014216004,482014216004,24262
881,881,48,201,421700,1,1547,599,1547,1082,465,453,262,93,4,94,0,0,12,1104,720,384,373,223,69,4,77,0,0,11,599,556,43,482014217001,15000US482014217001,482014217001,29297
882,882,48,201,421700,2,937,367,937,288,649,636,501,14,0,119,0,2,13,712,168,544,538,430,12,0,94,0,2,6,367,349,18,482014217002,15000US482014217002,482014217002,43102
883,883,48,201,421700,3,1202,483,1202,113,1089,1081,843,15,0,220,0,3,8,941,75,866,862,683,9,0,167,0,3,4,483,469,14,482014217003,15000US482014217003,482014217003,105250
884,884,48,201,421700,4,874,447,874,73,801,794,630,30,0,133,0,1,7,723,59,664,661,543,22,0,95,0,1,3,447,427,20,482014217004,15000US482014217004,482014217004,80550
885,885,48,201,421800,1,1422,859,1422,298,1124,1064,588,386,0,83,0,7,60,1152,223,929,892,517,305,0,66,0,4,37,859,754,105,482014218001,15000US482014218001,482014218001,47321
886,886,48,201,421800,2,1220,736,1220,390,830,812,247,518,10,34,0,3,18,907,268,639,624,214,373,9,28,0,0,15,736,590,146,482014218002,15000US482014218002,482014218002,36417
887,887,48,201,421800,3,1136,666,1136,190,946,923,548,237,1,136,0,1,23,915,143,772,756,467,182,1,105,0,1,16,666,578,88,482014218003,15000US482014218003,482014218003,50444
888,888,48,201,421800,4,1227,528,1227,93,1134,1118,893,18,1,204,0,2,16,974,67,907,895,723,11,1,158,0,2,12,528,505,23,482014218004,15000US482014218004,482014218004,85333
889,889,48,201,421900,1,998,409,998,107,891,880,809,25,2,42,0,2,11,756,67,689,684,626,22,2,32,0,2,5,409,394,15,482014219001,15000US482014219001,482014219001,104960
890,890,48,201,421900,2,1037,447,1037,84,953,948,878,17,1,46,0,6,5,810,53,757,754,703,12,1,36,0,2,3,447,430,17,482014219002,15000US482014219002,482014219002,81250
891,891,48,201,421900,3,655,271,655,42,613,609,574,8,0,24,0,3,4,483,31,452,449,425,5,0,16,0,3,3,271,259,12,482014219003,15000US482014219003,482014219003,115000
892,892,48,201,422000,1,683,287,683,64,619,611,544,21,1,45,0,0,8,541,43,498,494,434,17,1,42,0,0,4,287,280,7,482014220001,15000US482014220001,482014220001,102857
893,893,48,201,422000,2,859,369,859,103,756,752,675,37,1,36,0,3,4,680,70,610,608,550,28,1,26,0,3,2,369,352,17,482014220002,15000US482014220002,482014220002,109470
894,894,48,201,422000,3,997,425,997,163,834,813,705,44,5,56,0,3,21,773,113,660,648,572,30,3,42,0,1,12,425,408,17,482014220003,15000US482014220003,482014220003,101806
895,895,48,201,422100,1,1230,583,1230,489,741,727,467,226,1,29,1,3,14,938,304,634,624,419,179,1,22,1,2,10,583,520,63,482014221001,15000US482014221001,482014221001,60219
896,896,48,201,422100,2,972,332,972,441,531,518,315,134,5,59,3,2,13,716,272,444,436,272,102,3,55,2,2,8,332,315,17,482014221002,15000US482014221002,482014221002,59946
897,897,48,201,422100,3,1253,405,1253,708,545,528,274,200,6,48,0,0,17,906,471,435,424,232,145,6,41,0,0,11,405,381,24,482014221003,15000US482014221003,482014221003,54673
898,898,48,201,422100,4,917,328,917,428,489,477,256,153,0,68,0,0,12,691,295,396,387,228,105,0,54,0,0,9,328,306,22,482014221004,15000US482014221004,482014221004,56176
899,899,48,201,422100,5,917,398,917,198,719,702,573,89,0,39,0,1,17,745,138,607,596,499,66,0,30,0,1,11,398,383,15,482014221005,15000US482014221005,482014221005,120515
900,900,48,201,422200,1,1644,1216,1644,308,1336,1311,67,1212,3,21,0,8,25,1230,203,1027,1011,61,921,3,21,0,5,16,1216,788,428,482014222001,15000US482014222001,482014222001,20176
901,901,48,201,422200,2,2168,1003,2168,640,1528,1515,46,1449,2,17,0,1,13,1333,392,941,932,40,878,2,11,0,1,9,1003,703,300,482014222002,15000US482014222002,482014222002,29412
902,902,48,201,422200,3,609,455,609,59,550,539,16,515,1,7,0,0,11,447,41,406,400,15,377,1,7,0,0,6,455,287,168,482014222003,15000US482014222003,482014222003,31344
903,903,48,201,422301,1,1950,1131,1950,318,1632,1606,68,1505,4,29,0,0,26,1369,205,1164,1147,58,1070,1,18,0,0,17,1131,887,244,482014223011,15000US482014223011,482014223011,25482
904,904,48,201,422301,2,1780,600,1780,611,1169,1139,67,1014,0,55,0,3,30,1226,411,815,794,58,694,0,41,0,1,21,600,547,53,482014223012,15000US482014223012,482014223012,34836
905,905,48,201,422301,3,1345,526,1345,288,1057,1031,40,956,0,35,0,0,26,887,181,706,697,31,635,0,31,0,0,9,526,437,89,482014223013,15000US482014223013,482014223013,32109
906,906,48,201,422301,4,2033,628,2033,809,1224,1184,27,581,5,556,6,9,40,1305,519,786,764,21,359,2,369,6,7,22,628,533,95,482014223014,15000US482014223014,482014223014,22537
907,907,48,201,422302,1,2350,974,2350,619,1731,1708,372,1234,2,97,0,3,23,1748,441,1307,1295,335,872,2,85,0,1,12,974,908,66,482014223021,15000US482014223021,482014223021,59231
908,908,48,201,422401,1,1325,622,1325,632,693,679,147,484,1,42,0,5,14,922,414,508,500,128,342,1,28,0,1,8,622,458,164,482014224011,15000US482014224011,482014224011,31678
909,909,48,201,422401,2,1003,424,1003,368,635,627,49,566,0,12,0,0,8,676,212,464,461,43,412,0,6,0,0,3,424,400,24,482014224012,15000US482014224012,482014224012,25168
910,910,48,201,422401,3,1582,867,1582,291,1291,1284,254,873,6,147,0,4,7,1228,200,1028,1022,246,620,6,146,0,4,6,867,827,40,482014224013,15000US482014224013,482014224013,12028
911,911,48,201,422402,1,1526,518,1526,888,638,624,315,210,18,76,0,5,14,1035,543,492,482,271,144,14,51,0,2,10,518,480,38,482014224021,15000US482014224021,482014224021,25809
912,912,48,201,422402,2,1982,679,1982,1247,735,722,314,349,1,53,3,2,13,1363,792,571,565,267,249,0,44,3,2,6,679,627,52,482014224022,15000US482014224022,482014224022,25000
913,913,48,201,422402,3,1669,574,1669,1447,222,216,21,186,0,8,0,1,6,1091,942,149,146,17,120,0,8,0,1,3,574,490,84,482014224023,15000US482014224023,482014224023,29618
914,914,48,201,422402,4,897,394,897,192,705,698,559,68,1,68,0,2,7,726,140,586,585,479,50,1,55,0,0,1,394,383,11,482014224024,15000US482014224024,482014224024,79394
915,915,48,201,422500,1,2290,787,2290,1447,843,812,122,543,2,142,0,3,31,1428,811,617,596,100,400,0,93,0,3,21,787,700,87,482014225001,15000US482014225001,482014225001,18108
916,916,48,201,422500,2,1164,477,1164,160,1004,982,883,28,4,63,0,4,22,944,113,831,821,746,21,3,49,0,2,10,477,466,11,482014225002,15000US482014225002,482014225002,125364
917,917,48,201,422500,3,1163,856,1163,525,638,622,133,422,0,55,0,12,16,780,347,433,421,102,281,0,32,0,6,12,856,408,448,482014225003,15000US482014225003,482014225003,23177
918,918,48,201,422500,4,1030,562,1030,179,851,839,621,131,1,76,0,10,12,875,144,731,722,543,113,1,63,0,2,9,562,542,20,482014225004,15000US482014225004,482014225004,50489
919,919,48,201,422600,1,1313,556,1313,444,869,846,686,79,3,72,0,6,23,1026,308,718,701,575,62,3,59,0,2,17,556,525,31,482014226001,15000US482014226001,482014226001,47083
920,920,48,201,422600,2,890,403,890,335,555,545,504,32,1,5,0,3,10,686,222,464,460,432,20,1,5,0,2,4,403,371,32,482014226002,15000US482014226002,482014226002,68239
921,921,48,201,422600,3,2371,1006,2371,890,1481,1453,944,449,2,55,1,2,28,1806,574,1232,1215,829,334,2,49,1,0,17,1006,825,181,482014226003,15000US482014226003,482014226003,36549
922,922,48,201,422600,4,1806,684,1806,1370,436,428,260,134,0,27,0,7,8,1233,878,355,352,222,104,0,23,0,3,3,684,606,78,482014226004,15000US482014226004,482014226004,24087
923,923,48,201,422701,1,1838,672,1838,1218,620,604,166,404,0,23,0,11,16,1214,779,435,431,142,264,0,16,0,9,4,672,617,55,482014227011,15000US482014227011,482014227011,30956
924,924,48,201,422701,2,1250,397,1250,891,359,351,249,21,3,76,0,2,8,920,606,314,306,224,16,3,63,0,0,8,397,384,13,482014227012,15000US482014227012,482014227012,45167
925,925,48,201,422701,3,1995,608,1995,1423,572,562,443,58,3,56,0,2,10,1435,950,485,479,381,43,1,52,0,2,6,608,579,29,482014227013,15000US482014227013,482014227013,36842
926,926,48,201,422702,1,1816,611,1816,1141,675,646,453,89,3,98,0,3,29,1344,780,564,545,399,59,0,84,0,3,19,611,574,37,482014227021,15000US482014227021,482014227021,44871
927,927,48,201,422702,2,1531,505,1531,907,624,606,433,78,8,81,1,5,18,1186,657,529,517,386,52,7,68,1,3,12,505,482,23,482014227022,15000US482014227022,482014227022,44375
928,928,48,201,422800,1,1245,238,1245,172,1073,1052,800,178,2,67,2,3,21,1223,170,1053,1035,792,177,2,59,2,3,18,238,198,40,482014228001,15000US482014228001,482014228001,70234
929,929,48,201,422800,2,539,208,539,308,231,226,99,87,3,35,0,2,5,410,225,185,183,86,61,2,34,0,0,2,208,180,28,482014228002,15000US482014228002,482014228002,26786
930,930,48,201,422800,3,1837,722,1837,887,950,924,474,309,4,137,0,0,26,1410,599,811,800,426,250,3,121,0,0,11,722,667,55,482014228003,15000US482014228003,482014228003,45833
931,931,48,201,422800,4,1295,549,1295,1143,152,147,24,107,3,10,0,3,5,783,671,112,110,16,80,1,10,0,3,2,549,331,218,482014228004,15000US482014228004,482014228004,30350
932,932,48,201,422900,1,2707,1202,2707,1565,1142,1106,231,801,13,60,0,1,36,1904,1024,880,851,222,567,8,53,0,1,29,1202,1044,158,482014229001,15000US482014229001,482014229001,25179
933,933,48,201,422900,2,2320,838,2320,1426,894,869,353,403,2,106,0,5,25,1646,934,712,694,305,296,2,89,0,2,18,838,783,55,482014229002,15000US482014229002,482014229002,33487
934,934,48,201,423000,1,2013,1127,2013,1162,851,833,151,648,1,18,1,14,18,1402,726,676,664,133,507,1,15,1,7,12,1127,739,388,482014230001,15000US482014230001,482014230001,23525
935,935,48,201,423000,2,929,567,929,545,384,373,43,321,0,9,0,0,11,684,372,312,304,38,257,0,9,0,0,8,567,434,133,482014230002,15000US482014230002,482014230002,28209
936,936,48,201,423000,3,1753,661,1753,1262,491,482,349,73,4,44,0,12,9,1259,834,425,420,313,55,4,42,0,6,5,661,609,52,482014230003,15000US482014230003,482014230003,41212
937,937,48,201,423100,1,773,388,773,242,531,525,29,489,0,5,1,1,6,522,169,353,351,27,320,0,3,1,0,2,388,316,72,482014231001,15000US482014231001,482014231001,25590
938,938,48,201,423100,2,2388,751,2388,1937,451,445,26,400,1,14,0,4,6,1515,1215,300,298,21,266,0,8,0,3,2,751,697,54,482014231002,15000US482014231002,482014231002,25290
939,939,48,201,423201,1,1618,533,1618,702,916,890,376,429,1,81,0,3,26,1210,466,744,723,331,314,1,75,0,2,21,533,516,17,482014232011,15000US482014232011,482014232011,83594
940,940,48,201,423201,2,1615,538,1615,604,1011,996,352,541,0,96,1,6,15,1160,394,766,757,308,370,0,77,1,1,9,538,507,31,482014232012,15000US482014232012,482014232012,45673
941,941,48,201,423202,1,2742,1138,2742,1466,1276,1255,161,1067,7,20,0,0,21,1860,960,900,891,120,747,6,18,0,0,9,1138,989,149,482014232021,15000US482014232021,482014232021,24615
942,942,48,201,423202,2,2554,1228,2554,888,1666,1624,250,1172,1,197,0,4,42,1858,603,1255,1228,225,840,1,161,0,1,27,1228,1006,222,482014232022,15000US482014232022,482014232022,44625
943,943,48,201,423202,3,1693,742,1693,934,759,748,59,670,1,16,0,2,11,1115,619,496,488,44,429,1,14,0,0,8,742,591,151,482014232023,15000US482014232023,482014232023,22039
944,944,48,201,423301,1,1255,532,1255,383,872,860,551,249,5,47,1,7,12,976,262,714,705,468,188,5,41,1,2,9,532,510,22,482014233011,15000US482014233011,482014233011,65962
945,945,48,201,423301,2,1230,740,1230,210,1020,1009,625,294,3,87,0,0,11,986,142,844,839,552,216,1,70,0,0,5,740,512,228,482014233012,15000US482014233012,482014233012,59018
946,946,48,201,423301,3,1216,780,1216,479,737,726,145,516,0,53,1,11,11,873,302,571,563,131,381,0,47,1,3,8,780,539,241,482014233013,15000US482014233013,482014233013,25102
947,947,48,201,423302,1,1283,508,1283,192,1091,1080,420,576,1,75,0,8,11,1002,139,863,854,361,429,1,58,0,5,9,508,475,33,482014233021,15000US482014233021,482014233021,84375
948,948,48,201,423302,2,1681,994,1681,267,1414,1395,285,1074,2,30,0,4,19,1371,170,1201,1188,260,895,2,27,0,4,13,994,922,72,482014233022,15000US482014233022,482014233022,22801
949,949,48,201,423302,3,2159,902,2159,222,1937,1895,311,1399,5,173,0,7,42,1577,161,1416,1387,241,977,3,160,0,6,29,902,843,59,482014233023,15000US482014233023,482014233023,30429
950,950,48,201,423401,1,2012,793,2012,394,1618,1600,101,1415,0,83,0,1,18,1474,257,1217,1207,87,1040,0,79,0,1,10,793,728,65,482014234011,15000US482014234011,482014234011,62679
951,951,48,201,423401,2,1762,683,1762,341,1421,1402,428,907,4,46,9,8,19,1190,201,989,976,271,660,2,39,2,2,13,683,647,36,482014234012,15000US482014234012,482014234012,36000
952,952,48,201,423401,3,1379,436,1379,170,1209,1186,344,688,1,149,0,4,23,1016,115,901,887,240,517,1,126,0,3,14,436,424,12,482014234013,15000US482014234013,482014234013,84607
953,953,48,201,423402,1,2836,821,2836,644,2192,2172,75,1313,2,781,0,1,20,1990,432,1558,1548,70,863,2,613,0,0,10,821,804,17,482014234021,15000US482014234021,482014234021,66382
954,954,48,201,423402,2,1371,538,1371,248,1123,1101,82,965,0,52,0,2,22,1007,154,853,840,80,711,0,49,0,0,13,538,518,20,482014234022,15000US482014234022,482014234022,52357
955,955,48,201,423500,1,1927,722,1927,404,1523,1495,615,581,1,286,0,12,28,1498,268,1230,1209,532,440,1,232,0,4,21,722,698,24,482014235001,15000US482014235001,482014235001,73125
956,956,48,201,423600,1,1226,427,1226,460,766,759,48,630,4,70,0,7,7,822,291,531,526,46,421,3,52,0,4,5,427,398,29,482014236001,15000US482014236001,482014236001,46406
957,957,48,201,423600,2,615,223,615,158,457,452,43,332,1,75,0,1,5,469,109,360,356,39,252,1,63,0,1,4,223,215,8,482014236002,15000US482014236002,482014236002,50871
958,958,48,201,423600,4,700,217,700,213,487,484,59,401,2,22,0,0,3,496,141,355,353,47,286,2,18,0,0,2,217,198,19,482014236004,15000US482014236004,482014236004,58545
959,959,48,201,430100,1,791,568,791,88,703,696,626,34,0,36,0,0,7,713,71,642,635,574,27,0,34,0,0,7,568,491,77,482014301001,15000US482014301001,482014301001,53984
960,960,48,201,430100,2,1695,804,1695,155,1540,1496,1319,44,0,132,0,1,44,1365,123,1242,1213,1084,29,0,99,0,1,29,804,696,108,482014301002,15000US482014301002,482014301002,118384
961,961,48,201,430100,3,1483,933,1483,416,1067,1041,786,100,1,150,0,4,26,1229,320,909,896,684,82,1,125,0,4,13,933,822,111,482014301003,15000US482014301003,482014301003,53583
962,962,48,201,430100,4,688,385,688,174,514,507,408,27,2,68,0,2,7,537,136,401,397,319,27,1,48,0,2,4,385,334,51,482014301004,15000US482014301004,482014301004,53536
963,963,48,201,430100,5,1092,774,1092,104,988,975,891,15,0,63,1,5,13,972,72,900,892,825,14,0,48,1,4,8,774,607,167,482014301005,15000US482014301005,482014301005,52907
964,964,48,201,430200,1,1380,796,1380,256,1124,1107,940,31,4,126,0,6,17,1109,187,922,907,781,25,4,94,0,3,15,796,706,90,482014302001,15000US482014302001,482014302001,57169
965,965,48,201,430700,1,896,345,896,93,803,789,529,16,3,238,0,3,14,640,66,574,566,396,8,2,159,0,1,8,345,327,18,482014307001,15000US482014307001,482014307001,98462
966,966,48,201,430700,2,1338,959,1338,183,1155,1139,808,38,5,282,0,6,16,1139,142,997,985,746,30,5,200,0,4,12,959,856,103,482014307002,15000US482014307002,482014307002,35714
967,967,48,201,430700,3,1050,369,1050,34,1016,1014,943,1,1,67,0,2,2,719,19,700,698,653,1,1,43,0,0,2,369,359,10,482014307003,15000US482014307003,482014307003,153906
968,968,48,201,430800,1,2900,1490,2900,188,2712,2668,2209,45,8,400,5,1,44,2097,122,1975,1941,1600,36,8,292,5,0,34,1490,1138,352,482014308001,15000US482014308001,482014308001,140577
969,969,48,201,430800,2,1448,594,1448,80,1368,1354,1131,3,0,211,5,4,14,1023,52,971,966,823,2,0,134,3,4,5,594,568,26,482014308002,15000US482014308002,482014308002,111477
970,970,48,201,430900,1,1864,1017,1864,120,1744,1734,1640,4,1,87,0,2,10,1560,94,1466,1458,1382,4,1,69,0,2,8,1017,957,60,482014309001,15000US482014309001,482014309001,108333
971,971,48,201,430900,2,730,287,730,40,690,686,627,5,4,48,0,2,4,532,29,503,499,461,2,2,32,0,2,4,287,270,17,482014309002,15000US482014309002,482014309002,243750
972,972,48,201,430900,3,1433,664,1433,116,1317,1290,1059,10,0,217,1,3,27,1144,78,1066,1048,891,6,0,148,1,2,18,664,637,27,482014309003,15000US482014309003,482014309003,114750
973,973,48,201,430900,4,1743,799,1743,185,1558,1507,937,27,5,532,0,6,51,1296,142,1154,1114,736,20,3,354,0,1,40,799,742,57,482014309004,15000US482014309004,482014309004,63672
974,974,48,201,431000,1,1712,959,1712,275,1437,1408,1145,90,6,166,0,1,29,1495,207,1288,1267,1050,74,6,137,0,0,21,959,910,49,482014310001,15000US482014310001,482014310001,79077
975,975,48,201,431000,2,964,405,964,59,905,898,838,9,1,45,2,3,7,744,41,703,696,652,7,1,34,2,0,7,405,390,15,482014310002,15000US482014310002,482014310002,171563
976,976,48,201,431000,3,1390,769,1390,139,1251,1239,1058,61,0,117,0,3,12,1160,112,1048,1043,899,46,0,95,0,3,5,769,646,123,482014310003,15000US482014310003,482014310003,116125
977,977,48,201,431000,4,1173,521,1173,63,1110,1095,1024,16,2,52,0,1,15,940,51,889,881,828,9,2,41,0,1,8,521,507,14,482014310004,15000US482014310004,482014310004,123984
978,978,48,201,431101,1,680,412,680,31,649,642,601,6,0,32,0,3,7,658,30,628,621,583,6,0,31,0,1,7,412,391,21,482014311011,15000US482014311011,482014311011,106932
979,979,48,201,431101,2,1643,1136,1643,523,1120,1069,407,519,0,129,0,14,51,1421,412,1009,967,380,463,0,110,0,14,42,1136,954,182,482014311012,15000US482014311012,482014311012,40313
980,980,48,201,431101,3,980,726,980,166,814,778,655,56,2,63,1,1,36,898,148,750,724,616,50,2,54,1,1,26,726,632,94,482014311013,15000US482014311013,482014311013,68603
981,981,48,201,431102,1,1899,1195,1899,413,1486,1444,787,513,7,127,0,10,42,1614,313,1301,1268,721,412,7,119,0,9,33,1195,1032,163,482014311021,15000US482014311021,482014311021,44006
982,982,48,201,431102,2,1437,1067,1437,191,1246,1224,876,119,2,215,0,12,22,1335,172,1163,1144,823,114,2,199,0,6,19,1067,968,99,482014311022,15000US482014311022,482014311022,67263
983,983,48,201,431201,1,1468,946,1468,216,1252,1223,809,179,2,232,0,1,29,1339,184,1155,1133,778,151,1,202,0,1,22,946,860,86,482014312011,15000US482014312011,482014312011,71979
984,984,48,201,431201,2,2590,1533,2590,821,1769,1684,942,450,3,276,0,13,85,2202,628,1574,1509,851,395,0,250,0,13,65,1533,1403,130,482014312012,15000US482014312012,482014312012,40330
985,985,48,201,431202,1,1773,1054,1773,467,1306,1260,778,313,4,157,0,8,46,1473,367,1106,1078,682,252,4,135,0,5,28,1054,918,136,482014312021,15000US482014312021,482014312021,55069
986,986,48,201,431202,2,528,283,528,55,473,469,440,14,0,13,0,2,4,419,47,372,370,343,12,0,13,0,2,2,283,263,20,482014312022,15000US482014312022,482014312022,99653
987,987,48,201,431202,3,618,311,618,45,573,568,541,2,2,22,1,0,5,532,31,501,499,476,2,2,18,1,0,2,311,297,14,482014312023,15000US482014312023,482014312023,73850
988,988,48,201,431202,4,1673,1157,1673,317,1356,1325,639,205,6,474,0,1,31,1477,279,1198,1172,590,190,5,386,0,1,26,1157,1005,152,482014312024,15000US482014312024,482014312024,58099
989,989,48,201,431301,1,1580,1018,1580,420,1160,1121,757,213,5,144,0,2,39,1366,335,1031,1003,693,180,5,123,0,2,28,1018,900,118,482014313011,15000US482014313011,482014313011,39780
990,990,48,201,431301,2,1190,821,1190,354,836,809,541,155,3,102,0,8,27,1036,296,740,720,506,123,3,80,0,8,20,821,753,68,482014313012,15000US482014313012,482014313012,39453
991,991,48,201,431301,3,1746,1059,1746,520,1226,1190,840,205,7,131,1,6,36,1509,418,1091,1063,777,166,4,110,0,6,28,1059,977,82,482014313013,15000US482014313013,482014313013,45152
992,992,48,201,431302,1,1446,970,1446,201,1245,1206,993,77,0,133,0,3,39,1255,155,1100,1073,891,64,0,116,0,2,27,970,816,154,482014313021,15000US482014313021,482014313021,72770
993,993,48,201,431302,2,1512,622,1512,150,1362,1355,1302,20,1,23,0,9,7,1039,100,939,934,888,17,1,20,0,8,5,622,593,29,482014313022,15000US482014313022,482014313022,130500
994,994,48,201,431302,3,971,412,971,61,910,899,840,18,0,41,0,0,11,698,41,657,648,612,12,0,24,0,0,9,412,384,28,482014313023,15000US482014313023,482014313023,141838
995,995,48,201,431401,1,1281,982,1281,271,1010,980,784,70,1,118,3,4,30,1147,218,929,901,731,62,1,104,3,0,28,982,833,149,482014314011,15000US482014314011,482014314011,59345
996,996,48,201,431401,2,1058,771,1058,268,790,769,578,82,2,102,1,4,21,933,222,711,695,537,66,2,85,1,4,16,771,671,100,482014314012,15000US482014314012,482014314012,52336
997,997,48,201,431402,1,1870,1435,1870,246,1624,1577,1229,105,2,231,0,10,47,1738,223,1515,1474,1174,91,2,200,0,7,41,1435,1276,159,482014314021,15000US482014314021,482014314021,69271
998,998,48,201,431402,2,1339,921,1339,199,1140,1114,864,75,0,168,0,7,26,1219,170,1049,1026,817,66,0,137,0,6,23,921,799,122,482014314022,15000US482014314022,482014314022,72278
999,999,48,201,431501,1,894,732,894,103,791,781,712,19,1,49,0,0,10,830,90,740,731,670,16,1,44,0,0,9,732,619,113,482014315011,15000US482014315011,482014315011,75963
1000,1000,48,201,431501,2,1515,1153,1515,168,1347,1323,1191,23,4,101,2,2,24,1387,152,1235,1217,1099,22,3,89,2,2,18,1153,1021,132,482014315012,15000US482014315012,482014315012,81585
1001,1001,48,201,431501,3,1302,898,1302,153,1149,1116,892,44,1,173,0,6,33,1164,128,1036,1014,828,39,1,142,0,4,22,898,823,75,482014315013,15000US482014315013,482014315013,78924
1002,1002,48,201,431502,1,1138,837,1138,161,977,954,795,31,1,126,0,1,23,1056,137,919,901,761,28,1,110,0,1,18,837,747,90,482014315021,15000US482014315021,482014315021,84688
1003,1003,48,201,431502,2,1036,644,1036,71,965,951,862,12,1,73,0,3,14,942,60,882,874,801,8,1,63,0,1,8,644,601,43,482014315022,15000US482014315022,482014315022,74776
1004,1004,48,201,431502,3,1297,472,1297,78,1219,1214,1161,4,0,49,0,0,5,869,42,827,824,791,2,0,31,0,0,3,472,448,24,482014315023,15000US482014315023,482014315023,172404
1005,1005,48,201,431600,1,1050,458,1050,66,984,983,951,9,1,22,0,0,1,874,44,830,829,804,6,1,18,0,0,1,458,438,20,482014316001,15000US482014316001,482014316001,208000
1006,1006,48,201,431600,2,959,583,959,52,907,904,874,10,2,14,0,4,3,814,48,766,764,736,10,2,14,0,2,2,583,504,79,482014316002,15000US482014316002,482014316002,133875
1007,1007,48,201,431600,3,1343,703,1343,106,1237,1216,1156,22,9,25,0,4,21,1156,88,1068,1054,1006,21,5,19,0,3,14,703,639,64,482014316003,15000US482014316003,482014316003,105156
1008,1008,48,201,431700,1,1597,838,1597,148,1449,1419,1321,31,0,67,0,0,30,1315,105,1210,1189,1112,24,0,53,0,0,21,838,718,120,482014317001,15000US482014317001,482014317001,207708
1009,1009,48,201,431700,2,1734,1189,1734,166,1568,1542,1396,58,0,87,0,1,26,1594,135,1459,1439,1313,50,0,75,0,1,20,1189,991,198,482014317002,15000US482014317002,482014317002,122669
1010,1010,48,201,431700,3,1260,601,1260,58,1202,1183,1128,1,1,53,0,0,19,1027,42,985,977,933,1,1,42,0,0,8,601,532,69,482014317003,15000US482014317003,482014317003,185125
1011,1011,48,201,431801,1,725,408,725,40,685,676,626,7,0,42,0,1,9,646,33,613,608,569,7,0,31,0,1,5,408,376,32,482014318011,15000US482014318011,482014318011,118235
1012,1012,48,201,431801,2,1073,652,1073,113,960,945,440,34,3,460,0,8,15,882,96,786,772,352,32,0,380,0,8,14,652,536,116,482014318012,15000US482014318012,482014318012,59500
1013,1013,48,201,431801,3,1169,744,1169,161,1008,986,833,35,2,114,0,2,22,1010,137,873,859,726,32,1,99,0,1,14,744,679,65,482014318013,15000US482014318013,482014318013,72159
1014,1014,48,201,431802,1,1303,1088,1303,160,1143,1128,900,77,2,145,0,4,15,1244,145,1099,1087,866,73,2,142,0,4,12,1088,912,176,482014318021,15000US482014318021,482014318021,64896
1015,1015,48,201,431802,2,2392,1969,2392,470,1922,1863,1346,160,8,336,1,12,59,2131,401,1730,1684,1218,138,7,312,1,8,46,1969,1473,496,482014318022,15000US482014318022,482014318022,81413
1016,1016,48,201,431900,1,738,667,738,83,655,643,563,30,0,48,2,0,12,707,76,631,621,545,28,0,46,2,0,10,667,505,162,482014319001,15000US482014319001,482014319001,88229
1017,1017,48,201,431900,2,3048,2309,3048,551,2497,2446,1673,270,2,492,0,9,51,2850,506,2344,2306,1601,247,2,447,0,9,38,2309,1974,335,482014319002,15000US482014319002,482014319002,74973
1018,1018,48,201,432001,1,1655,1201,1655,588,1067,1042,566,343,0,124,2,7,25,1453,477,976,954,521,318,0,107,2,6,22,1201,993,208,482014320011,15000US482014320011,482014320011,40089
1019,1019,48,201,432001,2,1809,891,1809,317,1492,1449,1005,86,0,344,0,14,43,1450,232,1218,1193,858,62,0,264,0,9,25,891,787,104,482014320012,15000US482014320012,482014320012,118523
1020,1020,48,201,432002,1,1262,681,1262,792,470,457,150,269,0,38,0,0,13,1011,617,394,382,111,234,0,37,0,0,12,681,541,140,482014320021,15000US482014320021,482014320021,26800
1021,1021,48,201,432002,2,1532,987,1532,935,597,564,241,258,7,48,1,9,33,1330,780,550,519,222,237,5,46,1,8,31,987,795,192,482014320022,15000US482014320022,482014320022,22419
1022,1022,48,201,432002,3,1940,1116,1940,842,1098,1039,603,281,3,149,0,3,59,1611,628,983,936,551,253,2,128,0,2,47,1116,1007,109,482014320023,15000US482014320023,482014320023,37386
1023,1023,48,201,432100,1,2167,1291,2167,852,1315,1270,513,532,6,208,0,11,45,1820,671,1149,1118,463,461,5,182,0,7,31,1291,1145,146,482014321001,15000US482014321001,482014321001,40126
1024,1024,48,201,432100,2,2221,909,2221,1064,1157,1100,417,363,7,304,2,7,57,1756,796,960,914,349,304,3,252,2,4,46,909,867,42,482014321002,15000US482014321002,482014321002,40625
1025,1025,48,201,432100,3,666,287,666,47,619,602,557,7,3,35,0,0,17,522,37,485,474,435,6,1,32,0,0,11,287,274,13,482014321003,15000US482014321003,482014321003,226250
1026,1026,48,201,432200,1,986,467,986,200,786,762,655,41,2,64,0,0,24,816,154,662,648,561,30,2,55,0,0,14,467,442,25,482014322001,15000US482014322001,482014322001,72639
1027,1027,48,201,432200,2,669,360,669,127,542,536,409,74,0,53,0,0,6,570,100,470,466,358,62,0,46,0,0,4,360,330,30,482014322002,15000US482014322002,482014322002,60000
1028,1028,48,201,432200,3,2388,1278,2388,1074,1314,1274,506,573,2,190,0,3,40,1958,829,1129,1096,455,464,2,172,0,3,33,1278,1166,112,482014322003,15000US482014322003,482014322003,33355
1029,1029,48,201,432300,1,1865,1014,1865,685,1180,1151,324,702,5,114,0,6,29,1445,503,942,926,292,525,4,99,0,6,16,1014,911,103,482014323001,15000US482014323001,482014323001,42087
1030,1030,48,201,432300,2,1089,626,1089,446,643,620,176,345,4,90,2,3,23,893,332,561,540,173,284,2,78,2,1,21,626,594,32,482014323002,15000US482014323002,482014323002,25424
1031,1031,48,201,432300,3,2174,1102,2174,904,1270,1227,192,937,15,77,0,6,43,1615,631,984,964,171,712,15,63,0,3,20,1102,977,125,482014323003,15000US482014323003,482014323003,42188
1032,1032,48,201,432300,4,1393,910,1393,377,1016,993,309,429,6,240,3,6,23,1134,273,861,845,285,347,3,203,3,4,16,910,715,195,482014323004,15000US482014323004,482014323004,77850
1033,1033,48,201,432400,1,1408,914,1408,473,935,909,298,404,4,197,0,6,26,1153,362,791,772,272,322,1,174,0,3,19,914,766,148,482014324001,15000US482014324001,482014324001,42946
1034,1034,48,201,432400,2,2124,1208,2124,874,1250,1204,205,885,1,103,0,10,46,1630,617,1013,976,181,695,1,93,0,6,37,1208,1049,159,482014324002,15000US482014324002,482014324002,37303
1035,1035,48,201,432400,3,2016,1111,2016,777,1239,1192,437,632,2,112,0,9,47,1572,559,1013,982,373,500,1,99,0,9,31,1111,995,116,482014324003,15000US482014324003,482014324003,38537
1036,1036,48,201,432500,1,1803,938,1803,1068,735,725,217,461,2,41,0,4,10,1332,732,600,593,195,359,1,36,0,2,7,938,757,181,482014325001,15000US482014325001,482014325001,33161
1037,1037,48,201,432500,2,1953,893,1953,1135,818,796,289,400,2,99,0,6,22,1430,770,660,646,257,305,1,80,0,3,14,893,789,104,482014325002,15000US482014325002,482014325002,40694
1038,1038,48,201,432500,3,1773,816,1773,701,1072,1034,549,366,0,107,0,12,38,1311,478,833,811,443,274,0,86,0,8,22,816,730,86,482014325003,15000US482014325003,482014325003,31679
1039,1039,48,201,432600,1,702,292,702,76,626,622,572,10,4,35,1,0,4,552,52,500,497,457,8,4,27,1,0,3,292,280,12,482014326001,15000US482014326001,482014326001,138242
1040,1040,48,201,432600,2,1186,610,1186,467,719,699,271,379,0,41,2,6,20,883,318,565,551,230,284,0,33,2,2,14,610,525,85,482014326002,15000US482014326002,482014326002,38438
1041,1041,48,201,432701,1,2490,844,2490,2381,109,105,47,43,6,9,0,0,4,1838,1753,85,82,32,37,5,8,0,0,3,844,666,178,482014327011,15000US482014327011,482014327011,18616
1042,1042,48,201,432701,2,2851,1032,2851,2594,257,254,89,142,1,21,0,1,3,2173,1985,188,188,66,103,0,18,0,1,0,1032,814,218,482014327012,15000US482014327012,482014327012,21229
1043,1043,48,201,432701,3,1380,713,1380,937,443,435,247,134,11,36,1,6,8,1013,635,378,371,205,119,9,34,1,3,7,713,537,176,482014327013,15000US482014327013,482014327013,31462
1044,1044,48,201,432702,1,1493,876,1493,315,1178,1150,954,99,3,88,0,6,28,1294,266,1028,1005,831,94,3,73,0,4,23,876,810,66,482014327021,15000US482014327021,482014327021,48698
1045,1045,48,201,432702,2,1891,661,1891,1478,413,406,231,92,0,77,1,5,7,1364,1002,362,357,204,78,0,71,1,3,5,661,635,26,482014327022,15000US482014327022,482014327022,24013
1046,1046,48,201,432801,1,1581,917,1581,591,990,963,284,500,4,170,1,4,27,1188,401,787,766,240,371,0,151,1,3,21,917,713,204,482014328011,15000US482014328011,482014328011,27279
1047,1047,48,201,432801,2,1800,855,1800,1025,775,764,169,499,5,84,0,7,11,1294,699,595,586,136,370,5,69,0,6,9,855,703,152,482014328012,15000US482014328012,482014328012,25169
1048,1048,48,201,432801,3,1386,550,1386,812,574,553,136,256,3,148,0,10,21,955,536,419,407,102,171,3,123,0,8,12,550,461,89,482014328013,15000US482014328013,482014328013,22872
1049,1049,48,201,432802,1,1574,656,1574,1307,267,261,60,181,3,17,0,0,6,1098,913,185,182,46,118,3,15,0,0,3,656,476,180,482014328021,15000US482014328021,482014328021,31639
1050,1050,48,201,432802,2,2344,1287,2344,1353,991,965,325,322,1,315,0,2,26,1770,888,882,863,314,254,1,293,0,1,19,1287,1045,242,482014328022,15000US482014328022,482014328022,21065
1051,1051,48,201,432802,3,1495,709,1495,1016,479,465,164,202,0,98,0,1,14,1125,708,417,405,154,162,0,88,0,1,12,709,572,137,482014328023,15000US482014328023,482014328023,31961
1052,1052,48,201,432802,4,203,143,203,74,129,122,31,52,1,30,1,7,7,168,56,112,107,30,45,1,27,1,3,5,143,100,43,482014328024,15000US482014328024,482014328024,101250
1053,1053,48,201,432901,1,2638,910,2638,2136,502,493,108,325,2,41,0,17,9,1770,1399,371,364,82,236,2,36,0,8,7,910,817,93,482014329011,15000US482014329011,482014329011,35500
1054,1054,48,201,432901,2,846,304,846,460,386,377,228,45,0,102,0,2,9,651,313,338,332,205,32,0,93,0,2,6,304,292,12,482014329012,15000US482014329012,482014329012,31190
1055,1055,48,201,432902,1,1333,944,1333,901,432,419,226,76,0,109,8,0,13,1016,666,350,342,187,55,0,93,7,0,8,944,457,487,482014329021,15000US482014329021,482014329021,29000
1056,1056,48,201,432902,2,1999,967,1999,1379,620,607,90,381,4,131,0,1,13,1378,912,466,459,78,274,2,105,0,0,7,967,648,319,482014329022,15000US482014329022,482014329022,27527
1057,1057,48,201,432902,3,1144,607,1144,193,951,938,282,163,1,488,4,0,13,951,135,816,805,250,125,1,426,3,0,11,607,544,63,482014329023,15000US482014329023,482014329023,40625
1058,1058,48,201,433001,1,1061,429,1061,346,715,694,53,145,0,491,5,0,21,787,230,557,541,45,126,0,368,2,0,16,429,398,31,482014330011,15000US482014330011,482014330011,13920
1059,1059,48,201,433001,2,1913,593,1913,1676,237,233,65,93,2,61,10,2,4,1352,1130,222,218,61,89,2,55,10,1,4,593,535,58,482014330012,15000US482014330012,482014330012,24364
1060,1060,48,201,433001,3,2384,991,2384,1248,1136,1087,65,99,4,911,3,5,49,1599,872,727,688,54,72,1,555,3,3,39,991,729,262,482014330013,15000US482014330013,482014330013,26927
1061,1061,48,201,433002,1,1507,595,1507,742,765,759,20,55,5,679,0,0,6,1113,493,620,615,18,29,5,563,0,0,5,595,477,118,482014330021,15000US482014330021,482014330021,24143
1062,1062,48,201,433002,2,3352,1378,3352,2753,599,591,93,450,3,37,2,6,8,2442,1999,443,436,66,332,1,32,2,3,7,1378,1146,232,482014330022,15000US482014330022,482014330022,26094
1063,1063,48,201,433003,1,1908,880,1908,235,1673,1638,40,481,1,1115,0,1,35,1422,136,1286,1266,28,255,1,981,0,1,20,880,787,93,482014330031,15000US482014330031,482014330031,13393
1064,1064,48,201,433003,2,2923,1201,2923,1981,942,916,72,270,10,564,0,0,26,1976,1254,722,701,53,184,10,454,0,0,21,1201,970,231,482014330032,15000US482014330032,482014330032,26493
1065,1065,48,201,433100,1,1850,592,1850,1102,748,727,38,653,3,19,0,14,21,1077,612,465,452,20,407,1,18,0,6,13,592,559,33,482014331001,15000US482014331001,482014331001,30071
1066,1066,48,201,433100,2,1898,764,1898,1466,432,424,31,314,2,74,0,3,8,1181,850,331,326,28,225,2,69,0,2,5,764,550,214,482014331002,15000US482014331002,482014331002,31365
1067,1067,48,201,433201,1,2156,899,2156,800,1356,1321,154,605,5,552,0,5,35,1552,498,1054,1025,141,407,3,473,0,1,29,899,795,104,482014332011,15000US482014332011,482014332011,28110
1068,1068,48,201,433201,2,1620,670,1620,685,935,924,214,513,0,190,0,7,11,1173,466,707,701,200,346,0,152,0,3,6,670,621,49,482014332012,15000US482014332012,482014332012,32010
1069,1069,48,201,433201,3,1342,521,1342,221,1121,1103,307,81,0,713,2,0,18,1121,169,952,941,287,57,0,595,2,0,11,521,476,45,482014332013,15000US482014332013,482014332013,48438
1070,1070,48,201,433202,1,1576,579,1576,701,875,863,310,99,1,452,0,1,12,1187,467,720,715,273,62,1,379,0,0,5,579,519,60,482014332021,15000US482014332021,482014332021,46875
1071,1071,48,201,433202,2,2760,831,2760,1731,1029,1001,329,198,3,464,0,7,28,1872,1060,812,794,294,132,2,365,0,1,18,831,763,68,482014332022,15000US482014332022,482014332022,30474
1072,1072,48,201,433300,1,1973,657,1973,837,1136,1098,537,150,0,408,0,3,38,1502,567,935,917,478,97,0,339,0,3,18,657,628,29,482014333001,15000US482014333001,482014333001,50625
1073,1073,48,201,433300,2,1747,623,1747,704,1043,1028,656,83,0,287,0,2,15,1355,478,877,871,562,65,0,242,0,2,6,623,594,29,482014333002,15000US482014333002,482014333002,55795
1074,1074,48,201,433300,3,1476,522,1476,511,965,953,520,101,2,326,1,3,12,1209,367,842,834,480,78,2,272,1,1,8,522,495,27,482014333003,15000US482014333003,482014333003,62283
1075,1075,48,201,433400,1,3021,1283,3021,1910,1111,1083,251,634,2,192,0,4,28,2216,1337,879,863,216,476,1,166,0,4,16,1283,1162,121,482014334001,15000US482014334001,482014334001,22512
1076,1076,48,201,433400,2,1385,571,1385,601,784,761,218,348,1,188,0,6,23,1055,416,639,628,201,258,1,165,0,3,11,571,530,41,482014334002,15000US482014334002,482014334002,32105
1077,1077,48,201,433501,1,2216,702,2216,1504,712,696,39,636,0,17,0,4,16,1469,1050,419,412,29,367,0,14,0,2,7,702,673,29,482014335011,15000US482014335011,482014335011,21475
1078,1078,48,201,433501,2,2738,828,2738,2535,203,199,65,110,1,21,0,2,4,1838,1692,146,145,43,85,1,16,0,0,1,828,771,57,482014335012,15000US482014335012,482014335012,22672
1079,1079,48,201,433501,3,1207,574,1207,746,461,459,46,395,0,18,0,0,2,845,484,361,360,41,302,0,17,0,0,1,574,480,94,482014335013,15000US482014335013,482014335013,28992
1080,1080,48,201,433502,1,1917,872,1917,1198,719,710,48,538,0,120,0,4,9,1324,785,539,535,42,390,0,101,0,2,4,872,726,146,482014335021,15000US482014335021,482014335021,25276
1081,1081,48,201,433502,2,733,472,733,511,222,212,22,188,0,0,0,2,10,476,318,158,153,19,133,0,0,0,1,5,472,266,206,482014335022,15000US482014335022,482014335022,23750
1082,1082,48,201,433502,3,2414,922,2414,1977,437,430,41,166,2,218,0,3,7,1597,1277,320,317,36,115,2,163,0,1,3,922,739,183,482014335023,15000US482014335023,482014335023,21576
1083,1083,48,201,433502,4,2052,849,2052,1777,275,264,30,190,1,42,0,1,11,1335,1136,199,192,14,143,1,33,0,1,7,849,684,165,482014335024,15000US482014335024,482014335024,17157
1084,1084,48,201,433600,1,1484,910,1484,563,921,907,78,765,2,59,0,3,14,1045,373,672,664,68,537,1,55,0,3,8,910,644,266,482014336001,15000US482014336001,482014336001,20202
1085,1085,48,201,433600,2,661,328,661,490,171,166,27,118,0,20,0,1,5,442,308,134,132,27,85,0,19,0,1,2,328,235,93,482014336002,15000US482014336002,482014336002,17235
1086,1086,48,201,433600,3,1400,681,1400,397,1003,975,56,708,0,210,0,1,28,976,252,724,704,47,486,0,171,0,0,20,681,529,152,482014336003,15000US482014336003,482014336003,26649
1087,1087,48,201,433600,4,1736,972,1736,600,1136,1124,65,1012,10,33,0,4,12,1158,381,777,768,59,671,6,28,0,4,9,972,658,314,482014336004,15000US482014336004,482014336004,12398
1088,1088,48,201,440100,1,1365,533,1365,1224,141,135,41,65,0,24,4,1,6,1041,922,119,114,37,51,0,22,4,0,5,533,403,130,482014401001,15000US482014401001,482014401001,22676
1089,1089,48,201,440100,2,2049,748,2049,680,1369,1335,609,559,5,158,0,4,34,1541,463,1078,1052,519,391,5,136,0,1,26,748,723,25,482014401002,15000US482014401002,482014401002,67083
1090,1090,48,201,440100,3,126,42,126,34,92,90,25,47,0,18,0,0,2,99,27,72,70,20,33,0,17,0,0,2,42,41,1,482014401003,15000US482014401003,482014401003,78438
1091,1091,48,201,440100,4,502,319,502,445,57,54,8,43,1,2,0,0,3,376,337,39,36,8,25,1,2,0,0,3,319,176,143,482014401004,15000US482014401004,482014401004,28272
1092,1092,48,201,450100,1,1756,780,1756,168,1588,1559,1295,22,0,239,2,1,29,1267,110,1157,1145,977,13,0,154,1,0,12,780,730,50,482014501001,15000US482014501001,482014501001,68438
1093,1093,48,201,450200,1,1827,690,1827,109,1718,1697,1584,8,0,104,1,0,21,1242,63,1179,1173,1084,4,0,84,1,0,6,690,631,59,482014502001,15000US482014502001,482014502001,136719
1094,1094,48,201,450200,2,1880,647,1880,120,1760,1742,1433,6,7,290,0,6,18,1229,70,1159,1151,975,4,3,167,0,2,8,647,632,15,482014502002,15000US482014502002,482014502002,145000
1095,1095,48,201,450200,3,1165,470,1165,77,1088,1063,952,35,1,74,0,1,25,846,56,790,775,684,34,1,55,0,1,15,470,435,35,482014502003,15000US482014502003,482014502003,106823
1096,1096,48,201,450300,1,2362,979,2362,798,1564,1481,779,416,13,267,0,6,83,1635,484,1151,1098,649,242,4,199,0,4,53,979,860,119,482014503001,15000US482014503001,482014503001,47917
1097,1097,48,201,450300,2,2321,953,2321,665,1656,1619,812,641,8,150,1,7,37,1611,405,1206,1181,687,356,6,127,1,4,25,953,814,139,482014503002,15000US482014503002,482014503002,77276
1098,1098,48,201,450300,3,663,283,663,71,592,584,500,4,0,80,0,0,8,506,51,455,451,382,3,0,66,0,0,4,283,271,12,482014503003,15000US482014503003,482014503003,83448
1099,1099,48,201,450300,4,1678,832,1678,445,1233,1163,641,288,3,227,1,3,70,1248,290,958,915,542,197,3,171,1,1,43,832,706,126,482014503004,15000US482014503004,482014503004,63813
1100,1100,48,201,450400,1,2422,1356,2422,424,1998,1940,1397,248,5,281,2,7,58,1979,303,1676,1639,1200,194,5,233,2,5,37,1356,1224,132,482014504001,15000US482014504001,482014504001,63867
1101,1101,48,201,450400,2,1001,437,1001,204,797,761,483,203,0,70,0,5,36,730,134,596,573,387,131,0,53,0,2,23,437,364,73,482014504002,15000US482014504002,482014504002,56576
1102,1102,48,201,450400,3,1080,566,1080,383,697,674,397,160,3,95,0,19,23,809,261,548,534,335,112,3,72,0,12,14,566,453,113,482014504003,15000US482014504003,482014504003,76111
1103,1103,48,201,450500,1,1299,560,1299,85,1214,1195,1062,16,0,116,0,1,19,1073,56,1017,1000,892,11,0,96,0,1,17,560,541,19,482014505001,15000US482014505001,482014505001,164531
1104,1104,48,201,450500,2,1642,708,1642,163,1479,1452,1224,42,1,181,0,4,27,1353,119,1234,1215,1028,31,1,151,0,4,19,708,683,25,482014505002,15000US482014505002,482014505002,99107
1105,1105,48,201,450600,1,909,341,909,57,852,845,815,2,1,27,0,0,7,673,37,636,633,606,2,1,24,0,0,3,341,334,7,482014506001,15000US482014506001,482014506001,165268
1106,1106,48,201,450600,2,1690,628,1690,516,1174,1145,860,184,3,98,0,0,29,1196,316,880,868,660,127,3,78,0,0,12,628,600,28,482014506002,15000US482014506002,482014506002,102708
1107,1107,48,201,450600,3,1711,964,1711,265,1446,1401,1088,128,2,173,0,10,45,1381,200,1181,1152,919,81,1,144,0,7,29,964,852,112,482014506003,15000US482014506003,482014506003,60250
1108,1108,48,201,450700,1,1310,523,1310,119,1191,1163,1073,14,0,76,0,0,28,975,89,886,873,806,10,0,57,0,0,13,523,499,24,482014507001,15000US482014507001,482014507001,118750
1109,1109,48,201,450700,2,2654,932,2654,121,2533,2503,2337,1,3,160,2,0,30,1860,80,1780,1769,1653,1,3,110,2,0,11,932,906,26,482014507002,15000US482014507002,482014507002,151078
1110,1110,48,201,450700,3,2497,886,2497,122,2375,2337,2236,5,3,90,0,3,38,1793,79,1714,1697,1621,3,2,68,0,3,17,886,865,21,482014507003,15000US482014507003,482014507003,212679
1111,1111,48,201,450801,1,788,489,788,97,691,683,548,52,1,82,0,0,8,704,87,617,610,489,45,1,75,0,0,7,489,437,52,482014508011,15000US482014508011,482014508011,71439
1112,1112,48,201,450801,2,1382,751,1382,389,993,960,542,359,5,52,0,2,33,1146,292,854,837,501,284,5,46,0,1,17,751,720,31,482014508012,15000US482014508012,482014508012,48077
1113,1113,48,201,450802,1,916,368,916,64,852,839,776,23,0,40,0,0,13,691,38,653,642,595,13,0,34,0,0,11,368,357,11,482014508021,15000US482014508021,482014508021,165598
1114,1114,48,201,450802,2,1026,798,1026,300,726,710,366,283,2,58,0,1,16,743,201,542,534,308,176,2,48,0,0,8,798,389,409,482014508022,15000US482014508022,482014508022,28871
1115,1115,48,201,450802,3,1606,900,1606,551,1055,1033,413,590,0,26,0,4,22,1104,352,752,739,323,391,0,22,0,3,13,900,537,363,482014508023,15000US482014508023,482014508023,45446
1116,1116,48,201,450802,4,733,223,733,571,162,160,68,51,2,39,0,0,2,472,335,137,135,56,40,1,38,0,0,2,223,205,18,482014508024,15000US482014508024,482014508024,39818
1117,1117,48,201,450802,5,1710,1056,1710,516,1194,1144,437,505,1,191,0,10,50,1334,343,991,959,405,376,1,168,0,9,32,1056,775,281,482014508025,15000US482014508025,482014508025,47625
1118,1118,48,201,450900,1,848,398,848,87,761,750,682,19,2,43,0,4,11,683,63,620,612,558,15,2,33,0,4,8,398,373,25,482014509001,15000US482014509001,482014509001,105375
1119,1119,48,201,450900,2,1586,800,1586,339,1247,1219,881,165,2,167,2,2,28,1292,244,1048,1028,758,129,2,135,2,2,20,800,741,59,482014509002,15000US482014509002,482014509002,66761
1120,1120,48,201,451001,1,1548,675,1548,218,1330,1302,1014,94,2,191,0,1,28,1259,153,1106,1092,852,66,2,171,0,1,14,675,651,24,482014510011,15000US482014510011,482014510011,123947
1121,1121,48,201,451001,2,1749,978,1749,841,908,885,180,647,0,51,0,7,23,1311,565,746,726,166,510,0,49,0,1,20,978,827,151,482014510012,15000US482014510012,482014510012,25927
1122,1122,48,201,451001,3,1684,1007,1684,678,1006,984,310,604,2,59,0,9,22,1266,482,784,770,280,432,2,51,0,5,14,1007,827,180,482014510013,15000US482014510013,482014510013,22888
1123,1123,48,201,451002,1,1025,660,1025,304,721,694,251,372,3,64,0,4,27,856,227,629,609,234,311,3,59,0,2,20,660,572,88,482014510021,15000US482014510021,482014510021,34776
1124,1124,48,201,451002,2,1731,677,1731,483,1248,1228,154,1032,3,32,0,7,20,1164,323,841,827,109,686,3,26,0,3,14,677,628,49,482014510022,15000US482014510022,482014510022,39333
1125,1125,48,201,451002,3,1448,709,1448,551,897,872,85,737,2,29,14,5,25,957,355,602,586,76,470,2,24,9,5,16,709,566,143,482014510023,15000US482014510023,482014510023,23816
1126,1126,48,201,451002,4,905,590,905,153,752,732,442,188,2,99,0,1,20,793,125,668,654,413,149,2,89,0,1,14,590,532,58,482014510024,15000US482014510024,482014510024,68289
1127,1127,48,201,451100,1,578,387,578,53,525,522,438,25,0,56,1,2,3,534,42,492,489,414,22,0,50,1,2,3,387,357,30,482014511001,15000US482014511001,482014511001,86971
1128,1128,48,201,451100,2,1516,816,1516,437,1079,1046,812,126,4,101,0,3,33,1229,286,943,920,734,96,3,84,0,3,23,816,736,80,482014511002,15000US482014511002,482014511002,53075
1129,1129,48,201,451100,3,911,405,911,83,828,808,728,19,1,60,0,0,20,752,65,687,677,614,12,1,50,0,0,10,405,384,21,482014511003,15000US482014511003,482014511003,89766
1130,1130,48,201,451100,4,984,619,984,339,645,634,334,238,1,58,0,3,11,813,249,564,554,313,190,1,47,0,3,10,619,535,84,482014511004,15000US482014511004,482014511004,44833
1131,1131,48,201,451200,1,1451,588,1451,159,1292,1270,1192,27,0,46,0,5,22,1178,118,1060,1047,985,21,0,39,0,2,13,588,574,14,482014512001,15000US482014512001,482014512001,128359
1132,1132,48,201,451200,2,1224,539,1224,121,1103,1084,977,32,2,72,0,1,19,1015,97,918,904,825,24,2,52,0,1,14,539,518,21,482014512002,15000US482014512002,482014512002,111250
1133,1133,48,201,451300,1,1652,732,1652,209,1443,1402,1245,70,15,68,0,4,41,1346,167,1179,1156,1030,54,9,60,0,3,23,732,705,27,482014513001,15000US482014513001,482014513001,112604
1134,1134,48,201,451300,2,1984,990,1984,445,1539,1484,632,698,6,134,3,11,55,1569,332,1237,1203,550,528,4,110,3,8,34,990,954,36,482014513002,15000US482014513002,482014513002,38737
1135,1135,48,201,451300,3,2010,957,2010,339,1671,1619,1140,291,6,181,0,1,52,1614,246,1368,1330,962,209,3,155,0,1,38,957,886,71,482014513003,15000US482014513003,482014513003,64063
1136,1136,48,201,451300,4,1235,560,1235,208,1027,993,847,56,3,80,2,5,34,974,157,817,799,691,40,3,63,2,0,18,560,525,35,482014513004,15000US482014513004,482014513004,82466
1137,1137,48,201,451401,1,1543,907,1543,262,1281,1265,898,159,7,194,0,7,16,1279,189,1090,1081,787,120,7,162,0,5,9,907,809,98,482014514011,15000US482014514011,482014514011,47143
1138,1138,48,201,451401,2,1787,911,1787,456,1331,1307,765,407,0,126,0,9,24,1398,321,1077,1061,644,307,0,105,0,5,16,911,870,41,482014514012,15000US482014514012,482014514012,52656
1139,1139,48,201,451402,1,3108,1664,3108,801,2307,2251,1013,1038,7,165,3,25,56,2394,548,1846,1811,895,750,6,144,3,13,35,1664,1543,121,482014514021,15000US482014514021,482014514021,36684
1140,1140,48,201,451402,2,1435,922,1435,583,852,819,342,407,0,64,0,6,33,1161,444,717,692,309,327,0,54,0,2,25,922,781,141,482014514022,15000US482014514022,482014514022,38311
1141,1141,48,201,451403,1,2488,1712,2488,614,1874,1805,827,649,7,313,1,8,69,1994,454,1540,1492,711,522,5,250,1,3,48,1712,1316,396,482014514031,15000US482014514031,482014514031,29133
1142,1142,48,201,451403,2,1016,578,1016,159,857,839,514,159,4,160,0,2,18,854,128,726,716,447,135,2,132,0,0,10,578,537,41,482014514032,15000US482014514032,482014514032,64310
1143,1143,48,201,451500,1,3528,2303,3528,510,3018,2958,1816,404,7,730,0,1,60,3043,417,2626,2579,1655,334,5,584,0,1,47,2303,2009,294,482014515001,15000US482014515001,482014515001,73192
1144,1144,48,201,451500,2,1556,973,1556,401,1155,1114,520,384,3,198,1,8,41,1311,320,991,960,477,317,2,157,1,6,31,973,913,60,482014515002,15000US482014515002,482014515002,42261
1145,1145,48,201,451601,1,2076,891,2076,237,1839,1792,1437,56,2,287,0,10,47,1642,174,1468,1440,1173,36,1,225,0,5,28,891,856,35,482014516011,15000US482014516011,482014516011,123750
1146,1146,48,201,451601,2,3810,1879,3810,450,3360,3295,2319,196,2,770,1,7,65,3021,305,2716,2686,2007,142,2,528,1,6,30,1879,1715,164,482014516012,15000US482014516012,482014516012,98403
1147,1147,48,201,451602,1,3176,1281,3176,683,2493,2402,1580,250,9,551,5,7,91,2367,469,1898,1850,1237,195,7,401,5,5,48,1281,1212,69,482014516021,15000US482014516021,482014516021,114327
1148,1148,48,201,451602,2,4141,1945,4141,671,3470,3354,1821,437,12,1069,0,15,116,3182,491,2691,2620,1460,329,7,810,0,14,71,1945,1753,192,482014516022,15000US482014516022,482014516022,110158
1149,1149,48,201,451700,1,2195,1206,2195,459,1736,1698,478,1056,4,155,0,5,38,1674,315,1359,1336,450,752,3,129,0,2,23,1206,1028,178,482014517001,15000US482014517001,482014517001,44093
1150,1150,48,201,451700,2,470,178,470,102,368,355,159,61,1,134,0,0,13,366,76,290,286,133,43,1,109,0,0,4,178,171,7,482014517002,15000US482014517002,482014517002,65114
1151,1151,48,201,451800,1,818,272,818,354,464,437,177,139,10,108,0,3,27,597,239,358,344,151,90,6,94,0,3,14,272,254,18,482014518001,15000US482014518001,482014518001,50938
1152,1152,48,201,451800,2,795,270,795,345,450,432,117,209,2,103,0,1,18,593,247,346,331,104,145,1,81,0,0,15,270,265,5,482014518002,15000US482014518002,482014518002,57331
1153,1153,48,201,451800,3,1330,619,1330,574,756,732,268,274,0,189,1,0,24,968,387,581,567,218,178,0,170,1,0,14,619,422,197,482014518003,15000US482014518003,482014518003,37179
1154,1154,48,201,451901,1,657,281,657,182,475,466,96,335,0,33,2,0,9,468,119,349,342,88,224,0,29,1,0,7,281,267,14,482014519011,15000US482014519011,482014519011,48333
1155,1155,48,201,451901,2,2131,765,2131,722,1409,1371,612,359,1,390,0,9,38,1640,517,1123,1099,516,247,1,328,0,7,24,765,712,53,482014519012,15000US482014519012,482014519012,64426
1156,1156,48,201,451901,3,2013,1069,2013,609,1404,1375,248,936,4,185,0,2,29,1552,434,1118,1095,229,711,2,153,0,0,23,1069,913,156,482014519013,15000US482014519013,482014519013,40608
1157,1157,48,201,451901,4,2610,1420,2610,900,1710,1678,180,1451,1,44,0,2,32,1875,583,1292,1269,164,1062,1,40,0,2,23,1420,1229,191,482014519014,15000US482014519014,482014519014,29286
1158,1158,48,201,451902,1,2466,891,2466,283,2183,2139,841,175,0,1119,0,4,44,1885,209,1676,1647,659,120,0,864,0,4,29,891,854,37,482014519021,15000US482014519021,482014519021,123700
1159,1159,48,201,452000,1,1975,1036,1975,524,1451,1388,645,484,3,249,0,7,63,1605,392,1213,1170,576,377,3,209,0,5,43,1036,850,186,482014520001,15000US482014520001,482014520001,88750
1160,1160,48,201,452000,2,1156,574,1156,279,877,838,228,461,5,138,1,5,39,850,198,652,628,194,312,2,118,1,1,24,574,450,124,482014520002,15000US482014520002,482014520002,29554
1161,1161,48,201,452000,3,4005,2113,4005,1037,2968,2850,859,1451,9,526,1,4,118,3175,777,2398,2316,752,1131,4,424,1,4,82,2113,1948,165,482014520003,15000US482014520003,482014520003,49075
1162,1162,48,201,452100,1,1933,990,1933,470,1463,1417,324,854,8,230,0,1,46,1481,329,1152,1126,305,619,7,194,0,1,26,990,860,130,482014521001,15000US482014521001,482014521001,44146
1163,1163,48,201,452100,2,5290,2909,5290,983,4307,4199,2269,1165,5,745,0,15,108,4373,736,3637,3558,1986,940,3,614,0,15,79,2909,2646,263,482014521002,15000US482014521002,482014521002,63519
1164,1164,48,201,452100,3,1600,1020,1600,346,1254,1214,432,576,7,195,0,4,40,1390,285,1105,1072,402,484,6,176,0,4,33,1020,938,82,482014521003,15000US482014521003,482014521003,56875
1165,1165,48,201,452201,1,1252,752,1252,423,829,793,258,437,0,96,0,2,36,968,280,688,664,235,343,0,84,0,2,24,752,649,103,482014522011,15000US482014522011,482014522011,37614
1166,1166,48,201,452201,2,758,479,758,221,537,517,132,312,0,71,0,2,20,612,154,458,446,126,258,0,61,0,1,12,479,426,53,482014522012,15000US482014522012,482014522012,34931
1167,1167,48,201,452201,3,1575,958,1575,559,1016,966,262,592,5,102,4,1,50,1292,436,856,824,237,489,5,91,2,0,32,958,848,110,482014522013,15000US482014522013,482014522013,38060
1168,1168,48,201,452201,4,1630,1003,1630,600,1030,1006,203,661,5,134,0,3,24,1319,451,868,848,192,536,3,114,0,3,20,1003,895,108,482014522014,15000US482014522014,482014522014,29782
1169,1169,48,201,452202,1,730,485,730,94,636,624,256,236,0,129,0,3,12,649,78,571,560,241,201,0,115,0,3,11,485,458,27,482014522021,15000US482014522021,482014522021,53665
1170,1170,48,201,452202,2,2233,1240,2233,754,1479,1431,393,729,6,293,2,8,48,1780,567,1213,1182,359,564,5,246,2,6,31,1240,1066,174,482014522022,15000US482014522022,482014522022,37411
1171,1171,48,201,452300,1,2323,730,2323,1052,1271,1239,157,394,1,680,0,7,32,1719,693,1026,1001,138,279,1,577,0,6,25,730,685,45,482014523001,15000US482014523001,482014523001,44474
1172,1172,48,201,452400,1,2950,951,2950,1342,1608,1579,293,622,2,659,1,2,29,2143,927,1216,1199,267,401,1,529,1,0,17,951,903,48,482014524001,15000US482014524001,482014524001,39063
1173,1173,48,201,452400,2,2242,676,2242,1030,1212,1176,175,207,1,783,0,10,36,1608,681,927,913,167,142,1,596,0,7,14,676,658,18,482014524002,15000US482014524002,482014524002,39274
1174,1174,48,201,452400,3,961,343,961,376,585,580,96,431,0,52,0,1,5,624,235,389,384,77,264,0,43,0,0,5,343,295,48,482014524003,15000US482014524003,482014524003,41815
1175,1175,48,201,452400,4,2039,679,2039,1011,1028,1013,149,275,0,587,0,2,15,1465,664,801,789,130,166,0,491,0,2,12,679,647,32,482014524004,15000US482014524004,482014524004,35625
1176,1176,48,201,452500,1,2578,990,2578,722,1856,1812,137,1326,12,332,1,4,44,1655,461,1194,1173,122,779,8,263,1,0,21,990,866,124,482014525001,15000US482014525001,482014525001,24080
1177,1177,48,201,452500,2,2415,832,2415,1233,1182,1173,200,336,2,635,0,0,9,1619,751,868,863,173,224,2,464,0,0,5,832,718,114,482014525002,15000US482014525002,482014525002,32324
1178,1178,48,201,452500,3,2801,859,2801,1234,1567,1534,268,423,5,834,0,4,33,1981,819,1162,1145,232,264,4,641,0,4,17,859,806,53,482014525003,15000US482014525003,482014525003,52153
1179,1179,48,201,452600,1,0,0,0,0,0,0,0,0,0,0,0,0,0,0,0,0,0,0,0,0,0,0,0,0,0,0,0,482014526001,15000US482014526001,482014526001,28690
1180,1180,48,201,452600,2,681,204,681,272,409,399,141,151,0,107,0,0,10,515,183,332,325,122,116,0,87,0,0,7,204,194,10,482014526002,15000US482014526002,482014526002,60662
1181,1181,48,201,452600,3,0,0,0,0,0,0,0,0,0,0,0,0,0,0,0,0,0,0,0,0,0,0,0,0,0,0,0,482014526003,15000US482014526003,482014526003,43125
1182,1182,48,201,452700,1,1047,314,1047,567,480,446,63,216,4,155,0,8,34,752,381,371,350,56,156,2,133,0,3,21,314,299,15,482014527001,15000US482014527001,482014527001,50982
1183,1183,48,201,452700,2,621,179,621,288,333,331,37,132,1,160,0,1,2,437,193,244,244,29,83,1,130,0,1,0,179,170,9,482014527002,15000US482014527002,482014527002,52232
1184,1184,48,201,452700,4,97,40,97,12,85,84,4,35,0,41,4,0,1,75,8,67,66,4,25,0,34,3,0,1,40,32,8,482014527004,15000US482014527004,482014527004,35596
1185,1185,48,201,452801,1,2276,847,2276,622,1654,1614,285,592,4,728,1,4,40,1729,438,1291,1260,261,399,4,591,1,4,31,847,780,67,482014528011,15000US482014528011,482014528011,54659
1186,1186,48,201,452801,2,1303,373,1303,422,881,849,183,454,0,212,0,0,32,923,260,663,650,153,325,0,172,0,0,13,373,346,27,482014528012,15000US482014528012,482014528012,57639
1187,1187,48,201,452801,3,1170,429,1170,505,665,640,83,383,0,173,0,1,25,809,323,486,472,77,258,0,136,0,1,14,429,389,40,482014528013,15000US482014528013,482014528013,31991
1188,1188,48,201,452802,1,3239,1086,3239,1737,1502,1468,99,832,7,520,1,9,34,2086,1071,1015,997,86,487,4,415,1,4,18,1086,953,133,482014528021,15000US482014528021,482014528021,35446
1189,1189,48,201,452802,2,2710,847,2710,1186,1524,1492,127,660,2,702,0,1,32,1860,742,1118,1098,108,423,2,565,0,0,20,847,800,47,482014528022,15000US482014528022,482014528022,36563
1190,1190,48,201,452900,1,1871,650,1871,994,877,860,182,234,0,444,0,0,17,1327,648,679,666,164,158,0,344,0,0,13,650,585,65,482014529001,15000US482014529001,482014529001,32449
1191,1191,48,201,452900,2,2169,613,2169,1201,968,948,256,384,5,292,1,10,20,1499,773,726,715,221,236,4,247,1,6,11,613,565,48,482014529002,15000US482014529002,482014529002,31170
1192,1192,48,201,453000,1,2701,723,2701,1873,828,813,219,231,3,352,0,8,15,1873,1245,628,617,181,138,2,292,0,4,11,723,688,35,482014530001,15000US482014530001,482014530001,38931
1193,1193,48,201,453000,2,2536,685,2536,1642,894,873,252,157,4,449,1,10,21,1809,1064,745,729,238,109,2,372,1,7,16,685,662,23,482014530002,15000US482014530002,482014530002,39858
1194,1194,48,201,453000,3,2620,795,2620,1757,863,836,128,414,0,291,0,3,27,1705,1078,627,606,118,236,0,250,0,2,21,795,683,112,482014530003,15000US482014530003,482014530003,34191
1195,1195,48,201,453100,1,2046,1124,2046,1271,775,757,83,530,2,135,1,6,18,1354,800,554,543,74,353,1,112,1,2,11,1124,651,473,482014531001,15000US482014531001,482014531001,12380
1196,1196,48,201,453100,2,1220,534,1220,474,746,725,130,223,3,362,3,4,21,939,309,630,614,116,174,2,316,2,4,16,534,497,37,482014531002,15000US482014531002,482014531002,30625
1197,1197,48,201,453200,1,2515,888,2515,1210,1305,1276,323,567,10,360,5,11,29,1854,800,1054,1037,290,449,10,281,4,3,17,888,829,59,482014532001,15000US482014532001,482014532001,41884
1198,1198,48,201,453200,2,2572,861,2572,1651,921,895,63,497,4,330,0,1,26,1602,960,642,627,40,318,4,264,0,1,15,861,752,109,482014532002,15000US482014532002,482014532002,18188
1199,1199,48,201,453200,3,2860,1113,2860,1481,1379,1337,120,1030,6,177,1,3,42,1926,925,1001,967,99,706,4,154,1,3,34,1113,1039,74,482014532003,15000US482014532003,482014532003,21507
1200,1200,48,201,453300,1,2965,1299,2965,621,2344,2289,114,1506,3,652,1,13,55,2034,396,1638,1599,106,949,3,532,1,8,39,1299,1139,160,482014533001,15000US482014533001,482014533001,26199
1201,1201,48,201,453401,1,1684,640,1684,990,694,673,177,299,3,191,3,0,21,1174,637,537,522,154,206,3,156,3,0,15,640,587,53,482014534011,15000US482014534011,482014534011,28438
1202,1202,48,201,453401,2,1441,447,1441,828,613,602,284,163,13,140,0,2,11,1067,551,516,511,257,128,8,116,0,2,5,447,434,13,482014534012,15000US482014534012,482014534012,60000
1203,1203,48,201,453402,1,990,290,990,477,513,483,69,180,2,230,0,2,30,707,311,396,376,58,118,2,196,0,2,20,290,281,9,482014534021,15000US482014534021,482014534021,53547
1204,1204,48,201,453402,2,1976,672,1976,1112,864,851,123,472,3,250,0,3,13,1361,729,632,621,103,319,3,194,0,2,11,672,625,47,482014534022,15000US482014534022,482014534022,33167
1205,1205,48,201,453402,3,3249,1072,3249,1683,1566,1540,284,654,5,586,3,8,26,2256,1059,1197,1180,260,460,4,452,2,2,17,1072,978,94,482014534023,15000US482014534023,482014534023,39205
1206,1206,48,201,453402,4,1999,772,1999,949,1050,995,101,454,7,430,0,3,55,1352,589,763,721,92,301,2,324,0,2,42,772,662,110,482014534024,15000US482014534024,482014534024,28429
1207,1207,48,201,453403,1,1313,550,1313,426,887,879,68,458,0,351,0,2,8,932,264,668,663,60,324,0,277,0,2,5,550,407,143,482014534031,15000US482014534031,482014534031,50194
1208,1208,48,201,453403,2,1820,1036,1820,745,1075,1068,63,813,7,179,0,6,7,1261,473,788,782,50,559,6,162,0,5,6,1036,699,337,482014534032,15000US482014534032,482014534032,20885
1209,1209,48,201,453501,1,1940,556,1940,775,1165,1140,101,415,1,622,0,1,25,1423,509,914,899,89,286,1,522,0,1,15,556,530,26,482014535011,15000US482014535011,482014535011,41175
1210,1210,48,201,453501,2,2447,834,2447,958,1489,1427,274,624,9,505,0,15,62,1714,598,1116,1072,239,408,3,414,0,8,44,834,776,58,482014535012,15000US482014535012,482014535012,39726
1211,1211,48,201,453501,3,1787,760,1787,685,1102,1057,109,607,0,337,1,3,45,1208,425,783,759,72,409,0,276,1,1,24,760,625,135,482014535013,15000US482014535013,482014535013,38095
1212,1212,48,201,453502,1,1962,574,1962,813,1149,1128,241,641,1,239,1,5,21,1370,518,852,841,210,425,1,201,1,3,11,574,542,32,482014535021,15000US482014535021,482014535021,54915
1213,1213,48,201,453502,2,1723,561,1723,783,940,918,207,527,4,177,0,3,22,1172,502,670,662,189,328,1,142,0,2,8,561,510,51,482014535022,15000US482014535022,482014535022,41849
1214,1214,48,201,453601,1,2108,744,2108,936,1172,1139,159,703,2,267,0,8,33,1401,591,810,791,144,424,1,215,0,7,19,744,632,112,482014536011,15000US482014536011,482014536011,47540
1215,1215,48,201,453602,1,1615,467,1615,839,776,755,153,171,1,429,1,0,21,1170,551,619,604,141,113,1,349,0,0,15,467,434,33,482014536021,15000US482014536021,482014536021,43528
1216,1216,48,201,453602,2,1798,709,1798,510,1288,1258,218,846,2,192,0,0,30,1297,311,986,966,214,586,2,164,0,0,20,709,650,59,482014536022,15000US482014536022,482014536022,24811
1217,1217,48,201,453602,3,2389,777,2389,1338,1051,1019,108,574,0,331,1,5,32,1644,874,770,752,91,388,0,270,1,2,18,777,653,124,482014536023,15000US482014536023,482014536023,44500
1218,1218,48,201,453602,4,1897,525,1897,1235,662,650,104,255,1,287,0,3,12,1313,798,515,509,94,175,1,237,0,2,6,525,498,27,482014536024,15000US482014536024,482014536024,39274
1219,1219,48,201,453700,1,354,81,354,143,211,199,63,113,0,23,0,0,12,292,99,193,181,62,100,0,19,0,0,12,81,79,2,482014537001,15000US482014537001,482014537001,41213
1220,1220,48,201,453700,2,1069,330,1069,447,622,612,106,391,5,110,0,0,10,733,308,425,419,90,240,4,85,0,0,6,330,296,34,482014537002,15000US482014537002,482014537002,48125
1221,1221,48,201,453700,3,1613,725,1613,592,1021,1010,152,690,0,163,0,5,11,1126,365,761,758,137,482,0,137,0,2,3,725,579,146,482014537003,15000US482014537003,482014537003,40051
1222,1222,48,201,453700,4,2181,803,2181,807,1374,1348,146,975,3,222,1,1,26,1506,525,981,958,134,638,3,181,1,1,23,803,703,100,482014537004,15000US482014537004,482014537004,35927
1223,1223,48,201,453800,1,1700,585,1700,647,1053,1017,232,573,2,209,1,0,36,1215,410,805,786,214,382,2,187,1,0,19,585,532,53,482014538001,15000US482014538001,482014538001,57900
1224,1224,48,201,453800,2,1642,511,1642,767,875,868,318,339,3,205,0,3,7,1174,490,684,679,278,227,3,171,0,0,5,511,492,19,482014538002,15000US482014538002,482014538002,49107
1225,1225,48,201,453900,1,0,0,0,0,0,0,0,0,0,0,0,0,0,0,0,0,0,0,0,0,0,0,0,0,0,0,0,482014539001,15000US482014539001,482014539001,47250
1226,1226,48,201,454000,1,33,9,33,14,19,19,7,12,0,0,0,0,0,24,8,16,16,7,9,0,0,0,0,0,9,8,1,482014540001,15000US482014540001,482014540001,68529
1227,1227,48,201,454000,2,5,1,5,5,0,0,0,0,0,0,0,0,0,5,5,0,0,0,0,0,0,0,0,0,1,1,0,482014540002,15000US482014540002,482014540002,72148
1228,1228,48,201,454100,1,10,3,10,2,8,8,0,0,0,8,0,0,0,9,2,7,7,0,0,0,7,0,0,0,3,3,0,482014541001,15000US482014541001,482014541001,54750
1229,1229,48,201,454100,2,0,0,0,0,0,0,0,0,0,0,0,0,0,0,0,0,0,0,0,0,0,0,0,0,0,0,0,482014541002,15000US482014541002,482014541002,50511
1230,1230,48,201,454200,1,23,12,23,9,14,14,6,5,0,3,0,0,0,19,6,13,13,6,4,0,3,0,0,0,12,9,3,482014542001,15000US482014542001,482014542001,54732
1231,1231,48,201,454301,1,0,0,0,0,0,0,0,0,0,0,0,0,0,0,0,0,0,0,0,0,0,0,0,0,0,0,0,482014543011,15000US482014543011,482014543011,51076
1232,1232,48,201,454301,2,546,276,546,464,82,77,19,22,0,35,0,1,5,370,313,57,53,13,17,0,22,0,1,4,276,175,101,482014543012,15000US482014543012,482014543012,58125
1233,1233,48,201,454301,3,1666,1069,1666,395,1271,1240,365,682,5,183,0,5,31,1384,307,1077,1054,324,569,5,152,0,4,23,1069,913,156,482014543013,15000US482014543013,482014543013,32738
1234,1234,48,201,454301,4,1395,937,1395,401,994,950,189,616,3,133,0,9,44,1027,279,748,727,151,462,1,106,0,7,21,937,611,326,482014543014,15000US482014543014,482014543014,56850
1235,1235,48,201,454302,1,22,10,22,4,18,16,6,2,0,8,0,0,2,19,3,16,14,6,2,0,6,0,0,2,10,10,0,482014543021,15000US482014543021,482014543021,54477
1236,1236,48,201,454302,2,79,33,79,29,50,50,26,8,0,16,0,0,0,61,21,40,40,24,5,0,11,0,0,0,33,33,0,482014543022,15000US482014543022,482014543022,47241
1237,1237,48,201,454400,1,52,32,52,5,47,47,27,15,1,2,0,2,0,40,3,37,37,21,11,1,2,0,2,0,32,26,6,482014544001,15000US482014544001,482014544001,43716
1238,1238,48,201,454501,1,5,2,5,0,5,5,5,0,0,0,0,0,0,5,0,5,5,5,0,0,0,0,0,0,2,2,0,482014545011,15000US482014545011,482014545011,158702
1239,1239,48,201,454501,2,0,0,0,0,0,0,0,0,0,0,0,0,0,0,0,0,0,0,0,0,0,0,0,0,0,0,0,482014545012,15000US482014545012,482014545012,109167
1240,1240,48,201,454501,3,154,44,154,15,139,139,78,10,3,48,0,0,0,99,10,89,89,52,6,1,30,0,0,0,44,43,1,482014545013,15000US482014545013,482014545013,166058
1241,1241,48,201,454502,1,214,69,214,51,163,161,89,10,0,59,1,2,2,141,29,112,112,61,10,0,39,1,1,0,69,69,0,482014545021,15000US482014545021,482014545021,131583
1242,1242,48,201,454600,1,2289,1223,2289,654,1635,1576,1149,246,5,169,2,5,59,1779,466,1313,1293,979,183,4,122,1,4,20,1223,1144,79,482014546001,15000US482014546001,482014546001,56667
1243,1243,48,201,454700,2,61,19,61,15,46,44,37,7,0,0,0,0,2,40,10,30,28,25,3,0,0,0,0,2,19,18,1,482014547002,15000US482014547002,482014547002,58269
1244,1244,48,201,454800,1,0,0,0,0,0,0,0,0,0,0,0,0,0,0,0,0,0,0,0,0,0,0,0,0,0,0,0,482014548001,15000US482014548001,482014548001,97173
1245,1245,48,201,454800,2,0,0,0,0,0,0,0,0,0,0,0,0,0,0,0,0,0,0,0,0,0,0,0,0,0,0,0,482014548002,15000US482014548002,482014548002,63125
1246,1246,48,201,454800,3,1080,651,1080,238,842,814,575,145,10,75,2,7,28,886,180,706,690,503,110,5,63,2,7,16,651,626,25,482014548003,15000US482014548003,482014548003,55170
1247,1247,48,201,455101,1,6,4,6,0,6,6,6,0,0,0,0,0,0,5,0,5,5,5,0,0,0,0,0,0,4,4,0,482014551011,15000US482014551011,482014551011,48167
1248,1248,48,201,455101,2,19,9,19,6,13,12,9,0,0,3,0,0,1,16,5,11,10,8,0,0,2,0,0,1,9,8,1,482014551012,15000US482014551012,482014551012,67083
1249,1249,48,201,455102,2,0,0,0,0,0,0,0,0,0,0,0,0,0,0,0,0,0,0,0,0,0,0,0,0,0,0,0,482014551022,15000US482014551022,482014551022,75333
1250,1250,48,201,455200,1,27,11,27,13,14,14,11,1,0,2,0,0,0,22,9,13,13,10,1,0,2,0,0,0,11,11,0,482014552001,15000US482014552001,482014552001,76471
1251,1251,48,201,455200,2,15,4,15,6,9,9,9,0,0,0,0,0,0,14,5,9,9,9,0,0,0,0,0,0,4,4,0,482014552002,15000US482014552002,482014552002,68946
1252,1252,48,201,455200,3,12,2,12,9,3,3,2,1,0,0,0,0,0,8,6,2,2,2,0,0,0,0,0,0,2,2,0,482014552003,15000US482014552003,482014552003,125341
1253,1253,48,201,455300,1,699,250,699,210,489,478,246,212,2,17,1,0,11,475,124,351,345,202,126,2,14,1,0,6,250,234,16,482014553001,15000US482014553001,482014553001,45208
1254,1254,48,201,510100,1,1311,606,1311,466,845,840,552,240,3,43,0,2,5,1191,382,809,804,525,233,3,42,0,1,5,606,532,74,482015101001,15000US482015101001,482015101001,42135
1255,1255,48,201,510100,2,831,443,831,503,328,320,210,82,6,19,0,3,8,690,388,302,294,195,73,6,17,0,3,8,443,350,93,482015101002,15000US482015101002,482015101002,23125
1256,1256,48,201,510200,1,1189,505,1189,626,563,537,387,130,2,16,0,2,26,977,467,510,494,355,120,2,15,0,2,16,505,455,50,482015102001,15000US482015102001,482015102001,38025
1257,1257,48,201,510200,2,4243,2802,4243,886,3357,3282,2697,243,16,312,8,6,75,3926,759,3167,3108,2588,211,14,284,5,6,59,2802,2612,190,482015102002,15000US482015102002,482015102002,65636
1258,1258,48,201,510300,1,1333,676,1333,379,954,932,828,46,4,47,0,7,22,1082,285,797,785,693,43,4,39,0,6,12,676,587,89,482015103001,15000US482015103001,482015103001,119394
1259,1259,48,201,510300,2,1343,796,1343,369,974,948,859,52,3,31,1,2,26,1141,281,860,844,768,44,3,28,1,0,16,796,714,82,482015103002,15000US482015103002,482015103002,81477
1260,1260,48,201,510300,3,929,480,929,183,746,730,702,10,5,11,0,2,16,748,142,606,597,576,9,4,8,0,0,9,480,437,43,482015103003,15000US482015103003,482015103003,79706
1261,1261,48,201,510300,4,944,502,944,297,647,625,597,8,2,17,1,0,22,763,214,549,535,510,8,2,14,1,0,14,502,454,48,482015103004,15000US482015103004,482015103004,105263
1262,1262,48,201,510300,5,735,424,735,118,617,611,588,7,1,13,1,1,6,627,96,531,528,506,6,1,13,1,1,3,424,393,31,482015103005,15000US482015103005,482015103005,71583
1263,1263,48,201,510400,1,1517,881,1517,407,1110,1082,1012,34,1,31,0,4,28,1268,315,953,937,877,32,1,25,0,2,16,881,790,91,482015104001,15000US482015104001,482015104001,41932
1264,1264,48,201,510400,2,1034,544,1034,277,757,732,695,15,3,17,0,2,25,853,219,634,623,592,13,3,15,0,0,11,544,493,51,482015104002,15000US482015104002,482015104002,67471
1265,1265,48,201,510400,3,1286,804,1286,318,968,945,869,43,1,29,0,3,23,1140,258,882,864,794,37,1,29,0,3,18,804,734,70,482015104003,15000US482015104003,482015104003,83229
1266,1266,48,201,510500,1,1145,652,1145,425,720,700,640,34,0,24,0,2,20,943,301,642,625,569,30,0,24,0,2,17,652,552,100,482015105001,15000US482015105001,482015105001,56500
1267,1267,48,201,510500,2,682,370,682,257,425,409,326,59,1,20,0,3,16,566,194,372,365,290,54,1,18,0,2,7,370,305,65,482015105002,15000US482015105002,482015105002,42629
1268,1268,48,201,510500,3,1022,501,1022,349,673,660,449,172,2,32,0,5,13,821,238,583,575,395,145,2,28,0,5,8,501,440,61,482015105003,15000US482015105003,482015105003,93152
1269,1269,48,201,510600,1,1123,551,1123,413,710,701,574,39,1,82,1,4,9,947,318,629,624,516,30,1,73,1,3,5,551,496,55,482015106001,15000US482015106001,482015106001,101612
1270,1270,48,201,510600,2,2092,1171,2092,906,1186,1155,814,205,4,128,1,3,31,1807,706,1101,1071,777,172,4,116,1,1,30,1171,1040,131,482015106002,15000US482015106002,482015106002,61750
1271,1271,48,201,510600,3,1548,799,1548,540,1008,992,816,59,2,109,0,6,16,1358,431,927,914,758,51,2,97,0,6,13,799,712,87,482015106003,15000US482015106003,482015106003,141204
1272,1272,48,201,510700,1,1441,833,1441,318,1123,1091,888,53,8,139,0,3,32,1262,264,998,976,801,45,8,119,0,3,22,833,746,87,482015107001,15000US482015107001,482015107001,156944
1273,1273,48,201,510700,2,2070,1453,2070,402,1668,1630,1364,83,4,173,0,6,38,1952,352,1600,1566,1321,74,4,162,0,5,34,1453,1362,91,482015107002,15000US482015107002,482015107002,61377
1274,1274,48,201,510800,1,947,494,947,146,801,786,635,59,5,86,0,1,15,842,119,723,715,588,48,2,77,0,0,8,494,477,17,482015108001,15000US482015108001,482015108001,123333
1275,1275,48,201,510800,2,1553,1099,1553,154,1399,1388,1226,65,1,92,0,4,11,1469,142,1327,1319,1175,55,1,85,0,3,8,1099,956,143,482015108002,15000US482015108002,482015108002,110978
1276,1276,48,201,510800,3,1140,675,1140,184,956,946,817,38,0,87,1,3,10,1020,144,876,870,756,34,0,76,1,3,6,675,641,34,482015108003,15000US482015108003,482015108003,78064
1277,1277,48,201,510800,4,819,449,819,101,718,702,658,13,3,27,0,1,16,722,75,647,639,602,11,3,22,0,1,8,449,418,31,482015108004,15000US482015108004,482015108004,92763
1278,1278,48,201,510800,5,1265,744,1265,255,1010,981,816,70,2,93,0,0,29,1107,215,892,868,722,67,2,77,0,0,24,744,701,43,482015108005,15000US482015108005,482015108005,75395
1279,1279,48,201,510800,6,1184,662,1184,188,996,979,880,15,2,81,0,1,17,1046,152,894,883,800,13,1,69,0,0,11,662,617,45,482015108006,15000US482015108006,482015108006,148015
1280,1280,48,201,510900,1,2119,1000,2119,933,1186,1176,1026,52,3,80,0,15,10,1704,659,1045,1038,912,46,3,67,0,10,7,1000,928,72,482015109001,15000US482015109001,482015109001,77171
1281,1281,48,201,510900,2,2620,1326,2620,1147,1473,1422,1118,104,9,188,0,3,51,2193,834,1359,1327,1052,94,9,172,0,0,32,1326,1212,114,482015109002,15000US482015109002,482015109002,111364
1282,1282,48,201,510900,3,1331,595,1331,750,581,562,434,32,4,91,0,1,19,1082,559,523,511,397,26,4,83,0,1,12,595,539,56,482015109003,15000US482015109003,482015109003,67945
1283,1283,48,201,511001,1,1484,856,1484,244,1240,1203,1091,56,4,51,0,1,37,1307,198,1109,1079,970,54,4,50,0,1,30,856,800,56,482015110011,15000US482015110011,482015110011,59292
1284,1284,48,201,511001,2,1201,642,1201,350,851,843,745,61,8,25,0,4,8,1008,258,750,745,660,53,5,23,0,4,5,642,604,38,482015110012,15000US482015110012,482015110012,49318
1285,1285,48,201,511002,1,1814,1025,1814,520,1294,1275,1122,93,3,52,0,5,19,1535,398,1137,1126,988,84,3,46,0,5,11,1025,957,68,482015110021,15000US482015110021,482015110021,57500
1286,1286,48,201,511002,2,1474,935,1474,636,838,815,581,180,6,47,0,1,23,1227,483,744,729,529,152,6,42,0,0,15,935,846,89,482015110022,15000US482015110022,482015110022,48219
1287,1287,48,201,511002,3,973,489,973,124,849,839,772,14,8,42,1,2,10,840,99,741,735,685,12,6,30,1,1,6,489,473,16,482015110023,15000US482015110023,482015110023,106169
1288,1288,48,201,511100,1,1177,722,1177,377,800,787,542,201,4,38,1,1,13,1023,281,742,736,512,185,4,33,1,1,6,722,558,164,482015111001,15000US482015111001,482015111001,53125
1289,1289,48,201,511100,2,1499,826,1499,535,964,939,797,75,2,63,0,2,25,1281,409,872,859,730,66,2,59,0,2,13,826,704,122,482015111002,15000US482015111002,482015111002,105833
1290,1290,48,201,511200,1,871,473,871,219,652,642,537,65,3,35,0,2,10,764,167,597,587,492,58,3,32,0,2,10,473,426,47,482015112001,15000US482015112001,482015112001,71750
1291,1291,48,201,511200,2,1989,929,1989,833,1156,1130,946,121,5,55,1,2,26,1641,599,1042,1025,861,108,4,50,1,1,17,929,851,78,482015112002,15000US482015112002,482015112002,63926
1292,1292,48,201,511200,3,1564,891,1564,367,1197,1175,1050,56,1,67,0,1,22,1362,289,1073,1058,948,53,1,55,0,1,15,891,821,70,482015112003,15000US482015112003,482015112003,83902
1293,1293,48,201,511301,1,1206,697,1206,365,841,823,779,25,1,14,2,2,18,996,261,735,723,687,23,1,10,2,0,12,697,659,38,482015113011,15000US482015113011,482015113011,44167
1294,1294,48,201,511301,2,1063,582,1063,237,826,819,768,13,3,33,1,1,7,885,179,706,704,664,10,3,25,1,1,2,582,515,67,482015113012,15000US482015113012,482015113012,88558
1295,1295,48,201,511301,3,692,338,692,288,404,392,309,56,0,25,0,2,12,560,211,349,342,275,43,0,22,0,2,7,338,310,28,482015113013,15000US482015113013,482015113013,106250
1296,1296,48,201,511301,4,1009,473,1009,390,619,604,554,23,3,20,0,4,15,815,287,528,520,478,19,3,18,0,2,8,473,419,54,482015113014,15000US482015113014,482015113014,104107
1297,1297,48,201,511302,1,1060,607,1060,174,886,873,849,9,0,15,0,0,13,896,140,756,751,729,8,0,14,0,0,5,607,539,68,482015113021,15000US482015113021,482015113021,80840
1298,1298,48,201,511302,2,1331,753,1331,269,1062,1038,995,24,0,14,0,5,24,1102,201,901,885,847,22,0,12,0,4,16,753,658,95,482015113022,15000US482015113022,482015113022,43977
1299,1299,48,201,511302,3,1240,839,1240,267,973,954,876,46,0,30,0,2,19,1102,236,866,851,780,41,0,28,0,2,15,839,745,94,482015113023,15000US482015113023,482015113023,49861
1300,1300,48,201,511400,1,1164,716,1164,270,894,875,848,10,2,15,0,0,19,1038,222,816,806,782,10,1,13,0,0,10,716,657,59,482015114001,15000US482015114001,482015114001,62865
1301,1301,48,201,511400,2,896,490,896,291,605,589,565,11,1,11,0,1,16,732,207,525,516,496,8,1,10,0,1,9,490,430,60,482015114002,15000US482015114002,482015114002,93897
1302,1302,48,201,511400,3,941,427,941,622,319,310,293,10,0,6,0,1,9,712,429,283,276,261,8,0,6,0,1,7,427,393,34,482015114003,15000US482015114003,482015114003,56359
1303,1303,48,201,511500,1,640,291,640,355,285,285,257,17,0,7,0,4,0,510,255,255,255,229,15,0,7,0,4,0,291,248,43,482015115001,15000US482015115001,482015115001,27308
1304,1304,48,201,511500,2,854,447,854,441,413,408,380,15,0,12,1,0,5,715,337,378,374,350,15,0,8,1,0,4,447,391,56,482015115002,15000US482015115002,482015115002,53477
1305,1305,48,201,511500,3,903,414,903,495,408,395,367,12,3,11,0,2,13,724,371,353,343,321,8,3,9,0,2,10,414,363,51,482015115003,15000US482015115003,482015115003,59583
1306,1306,48,201,511500,4,713,396,713,140,573,568,547,7,2,10,0,2,5,615,115,500,495,475,7,2,9,0,2,5,396,350,46,482015115004,15000US482015115004,482015115004,92633
1307,1307,48,201,511500,5,1317,695,1317,539,778,761,696,40,3,20,0,2,17,1078,392,686,671,617,31,3,19,0,1,15,695,629,66,482015115005,15000US482015115005,482015115005,34620
1308,1308,48,201,511500,6,763,347,763,407,356,348,270,43,4,30,0,1,8,606,290,316,311,246,39,3,22,0,1,5,347,304,43,482015115006,15000US482015115006,482015115006,119038
1309,1309,48,201,511500,7,1282,592,1282,601,681,649,601,23,1,23,0,1,32,1017,433,584,568,527,19,1,21,0,0,16,592,537,55,482015115007,15000US482015115007,482015115007,49871
1310,1310,48,201,511600,1,1051,437,1051,745,306,302,262,20,2,17,1,0,4,796,524,272,269,235,19,1,13,1,0,3,437,375,62,482015116001,15000US482015116001,482015116001,33438
1311,1311,48,201,511600,2,794,279,794,665,129,125,111,3,1,6,0,4,4,560,440,120,116,103,2,1,6,0,4,4,279,247,32,482015116002,15000US482015116002,482015116002,30735
1312,1312,48,201,511600,3,1327,516,1327,1090,237,233,199,19,0,15,0,0,4,972,750,222,219,188,17,0,14,0,0,3,516,480,36,482015116003,15000US482015116003,482015116003,47344
1313,1313,48,201,511600,4,1469,541,1469,1183,286,271,225,21,0,17,6,2,15,1102,841,261,251,215,17,0,15,2,2,10,541,474,67,482015116004,15000US482015116004,482015116004,40500
1314,1314,48,201,520100,1,1597,934,1597,856,741,727,631,38,3,53,0,2,14,1241,611,630,619,547,28,3,41,0,0,11,934,603,331,482015201001,15000US482015201001,482015201001,54420
1315,1315,48,201,520200,1,576,262,576,153,423,420,377,22,1,20,0,0,3,439,111,328,327,298,14,1,14,0,0,1,262,238,24,482015202001,15000US482015202001,482015202001,60729
1316,1316,48,201,520200,2,1368,631,1368,110,1258,1248,1109,13,2,124,0,0,10,1016,88,928,922,827,10,2,83,0,0,6,631,608,23,482015202002,15000US482015202002,482015202002,142222
1317,1317,48,201,520200,3,1660,665,1660,928,732,715,554,99,4,55,0,3,17,1109,560,549,543,431,60,2,49,0,1,6,665,555,110,482015202003,15000US482015202003,482015202003,71042
1318,1318,48,201,520300,1,2089,841,2089,1391,698,674,534,86,4,47,1,2,24,1522,907,615,600,489,68,3,37,1,2,15,841,782,59,482015203001,15000US482015203001,482015203001,38466
1319,1319,48,201,520300,2,1444,467,1444,1158,286,284,183,67,4,26,1,3,2,1035,790,245,243,161,56,2,20,1,3,2,467,428,39,482015203002,15000US482015203002,482015203002,25956
1320,1320,48,201,520300,3,1593,654,1593,790,803,782,635,47,2,96,0,2,21,1223,527,696,682,551,44,2,83,0,2,14,654,574,80,482015203003,15000US482015203003,482015203003,34310
1321,1321,48,201,520400,1,1414,412,1414,1262,152,151,110,29,0,12,0,0,1,968,832,136,135,102,23,0,10,0,0,1,412,362,50,482015204001,15000US482015204001,482015204001,31766
1322,1322,48,201,520400,2,1665,661,1665,1213,452,442,328,99,4,11,0,0,10,1236,820,416,411,311,86,3,11,0,0,5,661,606,55,482015204002,15000US482015204002,482015204002,25682
1323,1323,48,201,520500,1,1700,572,1700,1384,316,309,253,43,5,7,0,1,7,1177,878,299,292,237,42,5,7,0,1,7,572,541,31,482015205001,15000US482015205001,482015205001,29127
1324,1324,48,201,520500,2,2663,1165,2663,1974,689,661,309,316,6,23,0,7,28,1861,1298,563,554,279,246,6,20,0,3,9,1165,948,217,482015205002,15000US482015205002,482015205002,29083
1325,1325,48,201,520500,3,1564,482,1564,1230,334,328,286,16,6,12,0,8,6,1067,779,288,284,252,14,4,9,0,5,4,482,445,37,482015205003,15000US482015205003,482015205003,39554
1326,1326,48,201,520500,4,1942,576,1942,1496,446,427,370,35,1,14,0,7,19,1366,983,383,371,333,25,1,7,0,5,12,576,539,37,482015205004,15000US482015205004,482015205004,40852
1327,1327,48,201,520601,1,2484,818,2484,1960,524,519,275,33,3,204,0,4,5,1733,1280,453,449,241,26,3,175,0,4,4,818,734,84,482015206011,15000US482015206011,482015206011,32647
1328,1328,48,201,520602,1,1142,421,1142,1029,113,111,82,16,3,10,0,0,2,743,648,95,93,71,12,1,9,0,0,2,421,290,131,482015206021,15000US482015206021,482015206021,27434
1329,1329,48,201,520602,2,1561,497,1561,1229,332,322,264,25,2,28,0,3,10,1097,805,292,283,235,21,2,25,0,0,9,497,458,39,482015206022,15000US482015206022,482015206022,32887
1330,1330,48,201,520602,3,1666,712,1666,1053,613,598,485,77,2,31,1,2,15,1250,706,544,535,443,61,2,27,1,1,9,712,644,68,482015206023,15000US482015206023,482015206023,40076
1331,1331,48,201,520602,4,1903,515,1903,1821,82,77,46,22,1,8,0,0,5,1189,1125,64,62,38,20,1,3,0,0,2,515,487,28,482015206024,15000US482015206024,482015206024,24527
1332,1332,48,201,520700,1,779,295,779,348,431,423,368,20,0,35,0,0,8,549,227,322,318,272,16,0,30,0,0,4,295,273,22,482015207001,15000US482015207001,482015207001,46923
1333,1333,48,201,520700,2,662,282,662,251,411,401,349,13,2,33,0,4,10,489,179,310,307,276,9,2,18,0,2,3,282,266,16,482015207002,15000US482015207002,482015207002,68654
1334,1334,48,201,520700,3,997,425,997,369,628,613,502,64,1,41,1,4,15,758,251,507,500,405,59,1,30,1,4,7,425,342,83,482015207003,15000US482015207003,482015207003,51439
1335,1335,48,201,520700,4,1286,442,1286,524,762,755,679,37,3,36,0,0,7,974,358,616,612,548,33,3,28,0,0,4,442,417,25,482015207004,15000US482015207004,482015207004,46528
1336,1336,48,201,521000,1,2103,761,2103,1407,696,682,563,90,2,22,1,4,14,1414,880,534,526,450,53,2,18,1,2,8,761,645,116,482015210001,15000US482015210001,482015210001,25625
1337,1337,48,201,521100,1,2177,717,2177,1778,399,390,341,12,0,36,0,1,9,1561,1236,325,321,282,9,0,30,0,0,4,717,633,84,482015211001,15000US482015211001,482015211001,27143
1338,1338,48,201,521200,1,2601,821,2601,2348,253,246,163,36,1,39,0,7,7,1672,1465,207,202,148,21,1,29,0,3,5,821,675,146,482015212001,15000US482015212001,482015212001,37197
1339,1339,48,201,521200,2,1988,733,1988,1175,813,798,573,144,4,64,0,13,15,1422,749,673,668,492,107,4,59,0,6,5,733,689,44,482015212002,15000US482015212002,482015212002,43508
1340,1340,48,201,521200,3,1739,805,1739,1196,543,527,289,154,2,70,0,12,16,1343,855,488,474,279,125,1,61,0,8,14,805,670,135,482015212003,15000US482015212003,482015212003,24557
1341,1341,48,201,521300,1,944,291,944,598,346,336,257,5,0,73,1,0,10,665,371,294,286,222,5,0,58,1,0,8,291,280,11,482015213001,15000US482015213001,482015213001,40962
1342,1342,48,201,521300,2,1289,411,1289,881,408,401,204,156,1,40,0,0,7,857,548,309,306,176,94,1,35,0,0,3,411,369,42,482015213002,15000US482015213002,482015213002,43305
1343,1343,48,201,521300,3,1034,302,1034,748,286,274,238,10,2,22,0,2,12,745,502,243,235,208,8,2,15,0,2,8,302,295,7,482015213003,15000US482015213003,482015213003,78237
1344,1344,48,201,521300,4,2172,872,2172,1349,823,806,501,108,2,191,0,4,17,1594,887,707,698,440,86,2,166,0,4,9,872,808,64,482015213004,15000US482015213004,482015213004,36750
1345,1345,48,201,521400,1,1242,365,1242,1177,65,63,29,20,0,13,0,1,2,803,763,40,38,15,13,0,9,0,1,2,365,304,61,482015214001,15000US482015214001,482015214001,24784
1346,1346,48,201,521400,2,2232,710,2232,2173,59,59,47,4,0,6,0,2,0,1440,1389,51,51,41,3,0,5,0,2,0,710,651,59,482015214002,15000US482015214002,482015214002,25161
1347,1347,48,201,521400,3,1478,458,1478,1129,349,346,318,9,0,15,0,4,3,1081,764,317,315,289,7,0,15,0,4,2,458,427,31,482015214003,15000US482015214003,482015214003,35053
1348,1348,48,201,521400,4,2641,714,2641,2492,149,144,115,16,2,7,0,4,5,1715,1609,106,103,85,9,2,6,0,1,3,714,688,26,482015214004,15000US482015214004,482015214004,18605
1349,1349,48,201,521500,1,1357,351,1357,1140,217,210,117,48,0,43,2,0,7,930,761,169,167,104,24,0,37,2,0,2,351,330,21,482015215001,15000US482015215001,482015215001,26412
1350,1350,48,201,521500,2,1104,353,1104,701,403,394,314,37,1,34,0,8,9,792,453,339,333,273,29,1,25,0,5,6,353,331,22,482015215002,15000US482015215002,482015215002,40179
1351,1351,48,201,521500,3,1387,467,1387,1105,282,279,206,32,3,34,0,4,3,940,711,229,228,175,19,3,28,0,3,1,467,437,30,482015215003,15000US482015215003,482015215003,26581
1352,1352,48,201,521500,4,2049,761,2049,947,1102,1078,897,47,4,127,1,2,24,1577,624,953,939,799,38,4,96,1,1,14,761,731,30,482015215004,15000US482015215004,482015215004,66927
1353,1353,48,201,521600,1,2095,580,2095,1560,535,526,403,45,1,72,2,3,9,1412,985,427,420,337,31,1,50,0,1,7,580,555,25,482015216001,15000US482015216001,482015216001,57639
1354,1354,48,201,521600,2,1537,455,1537,953,584,578,33,537,0,6,0,2,6,1016,585,431,427,27,395,0,4,0,1,4,455,401,54,482015216002,15000US482015216002,482015216002,26590
1355,1355,48,201,521700,1,1376,731,1376,910,466,458,133,310,2,6,6,1,8,998,632,366,360,120,228,2,6,3,1,6,731,574,157,482015217001,15000US482015217001,482015217001,33396
1356,1356,48,201,521700,2,1824,889,1824,1224,600,574,206,331,1,32,0,4,26,1303,824,479,465,187,249,1,28,0,0,14,889,705,184,482015217002,15000US482015217002,482015217002,29688
1357,1357,48,201,521700,3,2109,944,2109,1551,558,542,198,287,4,51,0,2,16,1510,1070,440,428,172,207,1,46,0,2,12,944,793,151,482015217003,15000US482015217003,482015217003,35030
1358,1358,48,201,521700,4,791,483,791,370,421,410,208,162,1,36,0,3,11,606,241,365,357,193,129,1,32,0,2,8,483,383,100,482015217004,15000US482015217004,482015217004,30664
1359,1359,48,201,521800,1,2756,994,2756,1112,1644,1601,541,359,2,693,0,6,43,2119,755,1364,1332,463,285,2,580,0,2,32,994,920,74,482015218001,15000US482015218001,482015218001,62500
1360,1360,48,201,521800,2,2926,923,2926,1699,1227,1205,553,129,2,521,0,0,22,2163,1143,1020,1006,483,97,1,425,0,0,14,923,886,37,482015218002,15000US482015218002,482015218002,58026
1361,1361,48,201,521900,1,3095,1436,3095,523,2572,2527,2110,88,3,324,0,2,45,2616,374,2242,2217,1854,64,3,294,0,2,25,1436,1250,186,482015219001,15000US482015219001,482015219001,66667
1362,1362,48,201,521900,2,2232,770,2232,1410,822,804,516,142,3,132,0,11,18,1493,819,674,663,454,95,2,104,0,8,11,770,721,49,482015219002,15000US482015219002,482015219002,41650
1363,1363,48,201,521900,3,1210,348,1210,770,440,430,199,24,4,202,0,1,10,878,516,362,356,161,17,4,173,0,1,6,348,331,17,482015219003,15000US482015219003,482015219003,46500
1364,1364,48,201,522000,1,1714,1182,1714,406,1308,1295,1112,95,0,87,0,1,13,1573,328,1245,1235,1063,89,0,82,0,1,10,1182,1088,94,482015220001,15000US482015220001,482015220001,43125
1365,1365,48,201,522000,2,852,279,852,519,333,328,287,14,1,26,0,0,5,599,315,284,283,250,11,1,21,0,0,1,279,271,8,482015220002,15000US482015220002,482015220002,46757
1366,1366,48,201,522000,3,1868,657,1868,1462,406,397,297,52,1,47,0,0,9,1330,999,331,325,251,31,1,42,0,0,6,657,508,149,482015220003,15000US482015220003,482015220003,28322
1367,1367,48,201,522100,1,1757,864,1757,931,826,804,514,159,1,128,0,2,22,1339,640,699,685,451,128,1,104,0,1,14,864,773,91,482015221001,15000US482015221001,482015221001,31205
1368,1368,48,201,522100,2,1523,563,1523,684,839,831,747,37,8,38,0,1,8,1179,452,727,723,651,28,8,35,0,1,4,563,536,27,482015221002,15000US482015221002,482015221002,67667
1369,1369,48,201,522100,3,2816,840,2816,1894,922,900,474,405,4,15,1,1,22,1743,1077,666,656,421,215,4,14,1,1,10,840,761,79,482015221003,15000US482015221003,482015221003,33731
1370,1370,48,201,522100,4,1349,589,1349,688,661,651,484,119,6,42,0,0,10,1008,457,551,543,420,91,4,28,0,0,8,589,533,56,482015221004,15000US482015221004,482015221004,21349
1371,1371,48,201,522201,1,1460,510,1460,1168,292,285,133,105,2,40,0,5,7,953,738,215,213,108,70,2,31,0,2,2,510,395,115,482015222011,15000US482015222011,482015222011,34677
1372,1372,48,201,522201,2,2227,841,2227,1245,982,969,807,67,2,89,1,3,13,1662,821,841,836,707,48,1,80,0,0,5,841,768,73,482015222012,15000US482015222012,482015222012,61346
1373,1373,48,201,522202,1,1785,735,1785,1186,599,588,439,81,6,55,0,7,11,1235,738,497,489,375,58,3,50,0,3,8,735,551,184,482015222021,15000US482015222021,482015222021,74423
1374,1374,48,201,522202,2,1870,619,1870,1158,712,696,467,143,2,75,0,9,16,1311,731,580,572,410,89,2,64,0,7,8,619,566,53,482015222022,15000US482015222022,482015222022,46979
1375,1375,48,201,522301,1,1502,647,1502,630,872,844,722,48,8,65,1,0,28,1185,427,758,745,634,46,6,58,1,0,13,647,595,52,482015223011,15000US482015223011,482015223011,41176
1376,1376,48,201,522301,2,2624,955,2624,1938,686,668,370,194,6,92,0,6,18,1774,1232,542,532,317,127,5,79,0,4,10,955,878,77,482015223012,15000US482015223012,482015223012,37530
1377,1377,48,201,522302,1,2109,659,2109,1808,301,296,158,47,1,86,0,4,5,1514,1266,248,246,133,35,1,75,0,2,2,659,590,69,482015223021,15000US482015223021,482015223021,23077
1378,1378,48,201,522302,2,1800,856,1800,866,934,917,752,53,2,102,1,7,17,1434,598,836,824,685,43,2,90,1,3,12,856,775,81,482015223022,15000US482015223022,482015223022,71678
1379,1379,48,201,522401,1,880,361,880,236,644,622,576,11,1,27,2,5,22,718,162,556,543,505,8,1,26,2,1,13,361,346,15,482015224011,15000US482015224011,482015224011,89009
1380,1380,48,201,522401,2,1197,509,1197,290,907,895,813,27,3,49,0,3,12,966,188,778,770,701,19,2,46,0,2,8,509,483,26,482015224012,15000US482015224012,482015224012,76333
1381,1381,48,201,522401,3,1696,865,1696,939,757,747,609,59,7,53,2,17,10,1274,657,617,611,498,48,7,47,2,9,6,865,613,252,482015224013,15000US482015224013,482015224013,34010
1382,1382,48,201,522401,4,1486,514,1486,1266,220,202,112,32,0,54,0,4,18,994,833,161,147,83,20,0,40,0,4,14,514,418,96,482015224014,15000US482015224014,482015224014,25656
1383,1383,48,201,522402,1,3020,951,3020,1947,1073,1049,891,83,4,58,4,9,24,2032,1138,894,876,769,51,4,42,3,7,18,951,895,56,482015224021,15000US482015224021,482015224021,63444
1384,1384,48,201,522402,2,900,361,900,386,514,512,422,29,8,45,1,7,2,680,250,430,429,366,18,6,35,1,3,1,361,342,19,482015224022,15000US482015224022,482015224022,61875
1385,1385,48,201,522500,1,0,0,0,0,0,0,0,0,0,0,0,0,0,0,0,0,0,0,0,0,0,0,0,0,0,0,0,482015225001,15000US482015225001,482015225001,175000
1386,1386,48,201,530100,1,973,391,973,847,126,121,42,71,0,8,0,0,5,672,567,105,100,33,60,0,7,0,0,5,391,321,70,482015301001,15000US482015301001,482015301001,37545
1387,1387,48,201,530100,2,2419,1050,2419,1731,688,680,392,273,1,7,0,7,8,1725,1139,586,580,357,211,1,6,0,5,6,1050,833,217,482015301002,15000US482015301002,482015301002,30915
1388,1388,48,201,530100,3,1241,496,1241,884,357,350,246,91,2,7,0,4,7,855,545,310,305,221,74,2,7,0,1,5,496,426,70,482015301003,15000US482015301003,482015301003,27440
1389,1389,48,201,530100,4,1600,798,1600,1093,507,498,330,152,1,10,0,5,9,1220,765,455,446,306,128,1,9,0,2,9,798,687,111,482015301004,15000US482015301004,482015301004,34155
1390,1390,48,201,530200,1,1124,648,1124,254,870,852,794,23,1,33,0,1,18,890,182,708,697,650,20,1,25,0,1,11,648,477,171,482015302001,15000US482015302001,482015302001,91429
1391,1391,48,201,530200,2,1501,729,1501,658,843,824,732,34,6,48,2,2,19,1214,472,742,727,651,23,5,45,2,1,15,729,617,112,482015302002,15000US482015302002,482015302002,43675
1392,1392,48,201,530200,3,748,297,748,333,415,410,357,40,4,8,0,1,5,611,235,376,374,322,39,4,8,0,1,2,297,287,10,482015302003,15000US482015302003,482015302003,57841
1393,1393,48,201,530300,1,688,332,688,202,486,477,5,470,1,0,0,1,9,525,116,409,403,5,396,1,0,0,1,6,332,265,67,482015303001,15000US482015303001,482015303001,18646
1394,1394,48,201,530300,2,504,283,504,150,354,347,9,334,1,0,0,3,7,397,85,312,306,8,295,0,0,0,3,6,283,220,63,482015303002,15000US482015303002,482015303002,20417
1395,1395,48,201,530300,3,1208,616,1208,337,871,868,24,833,4,3,0,4,3,911,194,717,715,21,685,3,2,0,4,2,616,463,153,482015303003,15000US482015303003,482015303003,22993
1396,1396,48,201,530400,1,1620,647,1620,681,939,935,26,901,0,8,0,0,4,1217,435,782,781,20,755,0,6,0,0,1,647,549,98,482015304001,15000US482015304001,482015304001,21125
1397,1397,48,201,530400,2,982,428,982,422,560,555,95,454,3,2,0,1,5,764,266,498,493,94,393,3,2,0,1,5,428,365,63,482015304002,15000US482015304002,482015304002,20959
1398,1398,48,201,530500,1,1525,540,1525,701,824,818,58,743,3,8,1,5,6,1071,417,654,650,45,590,3,8,1,3,4,540,468,72,482015305001,15000US482015305001,482015305001,24500
1399,1399,48,201,530500,2,1642,661,1642,817,825,823,98,715,4,4,0,2,2,1246,557,689,689,82,599,2,4,0,2,0,661,526,135,482015305002,15000US482015305002,482015305002,45000
1400,1400,48,201,530500,3,1596,647,1596,911,685,680,50,611,3,10,0,6,5,1125,564,561,557,40,501,2,10,0,4,4,647,519,128,482015305003,15000US482015305003,482015305003,20060
1401,1401,48,201,530600,1,2119,715,2119,1168,951,930,417,493,4,11,0,5,21,1564,720,844,829,388,421,4,11,0,5,15,715,638,77,482015306001,15000US482015306001,482015306001,24526
1402,1402,48,201,530600,2,1493,681,1493,740,753,747,128,610,1,7,0,1,6,1109,470,639,634,117,508,1,7,0,1,5,681,526,155,482015306002,15000US482015306002,482015306002,40625
1403,1403,48,201,530700,1,1712,575,1712,1400,312,309,144,160,1,2,0,2,3,1181,925,256,253,118,132,1,2,0,0,3,575,487,88,482015307001,15000US482015307001,482015307001,25362
1404,1404,48,201,530700,2,2500,799,2500,1580,920,909,196,701,4,4,0,4,11,1571,971,600,597,181,407,3,4,0,2,3,799,768,31,482015307002,15000US482015307002,482015307002,28158
1405,1405,48,201,530700,3,1394,432,1394,627,767,767,103,657,0,7,0,0,0,949,409,540,540,95,438,0,7,0,0,0,432,405,27,482015307003,15000US482015307003,482015307003,26188
1406,1406,48,201,530800,1,1216,531,1216,175,1041,1028,52,968,6,2,0,0,13,912,108,804,794,22,764,6,2,0,0,10,531,443,88,482015308001,15000US482015308001,482015308001,18625
1407,1407,48,201,530800,2,812,312,812,115,697,696,16,679,1,0,0,0,1,584,74,510,510,13,497,0,0,0,0,0,312,274,38,482015308002,15000US482015308002,482015308002,18750
1408,1408,48,201,530800,3,1821,863,1821,229,1592,1582,203,1369,2,6,0,2,10,1531,148,1383,1375,183,1183,2,5,0,2,8,863,802,61,482015308003,15000US482015308003,482015308003,56193
1409,1409,48,201,530900,1,1152,420,1152,867,285,273,193,76,1,2,0,1,12,817,574,243,237,170,63,1,2,0,1,6,420,358,62,482015309001,15000US482015309001,482015309001,30625
1410,1410,48,201,530900,2,1584,701,1584,443,1141,1125,761,346,1,13,0,4,16,1225,290,935,924,658,250,1,12,0,3,11,701,659,42,482015309002,15000US482015309002,482015309002,39473
1411,1411,48,201,530900,3,1451,632,1451,221,1230,1220,1185,14,4,16,0,1,10,1180,159,1021,1016,985,13,4,13,0,1,5,632,611,21,482015309003,15000US482015309003,482015309003,64129
1412,1412,48,201,531000,1,1320,619,1320,346,974,957,907,14,5,30,0,1,17,1050,240,810,802,758,14,3,26,0,1,8,619,578,41,482015310001,15000US482015310001,482015310001,76875
1413,1413,48,201,531000,2,2309,1046,2309,747,1562,1532,1470,27,5,28,0,2,30,1784,508,1276,1258,1204,25,2,25,0,2,18,1046,961,85,482015310002,15000US482015310002,482015310002,75766
1414,1414,48,201,531100,1,1152,584,1152,291,861,847,812,14,3,18,0,0,14,956,207,749,740,709,13,2,16,0,0,9,584,546,38,482015311001,15000US482015311001,482015311001,65648
1415,1415,48,201,531100,2,1702,753,1702,663,1039,1022,953,37,9,20,2,1,17,1330,443,887,877,817,28,9,20,2,1,10,753,694,59,482015311002,15000US482015311002,482015311002,60134
1416,1416,48,201,531200,1,1066,521,1066,646,420,411,184,218,3,3,3,0,9,718,413,305,302,168,128,3,3,0,0,3,521,359,162,482015312001,15000US482015312001,482015312001,33750
1417,1417,48,201,531200,2,1276,657,1276,292,984,974,914,9,0,48,0,3,10,1090,214,876,870,814,9,0,44,0,3,6,657,619,38,482015312002,15000US482015312002,482015312002,54805
1418,1418,48,201,531200,3,820,427,820,203,617,610,563,36,4,5,1,1,7,692,160,532,529,485,33,4,5,1,1,3,427,403,24,482015312003,15000US482015312003,482015312003,58942
1419,1419,48,201,531300,1,1884,727,1884,1518,366,344,136,196,2,8,0,2,22,1262,971,291,282,124,150,2,4,0,2,9,727,578,149,482015313001,15000US482015313001,482015313001,33117
1420,1420,48,201,531300,2,1513,709,1513,495,1018,998,882,68,2,45,0,1,20,1280,359,921,905,796,63,2,43,0,1,16,709,668,41,482015313002,15000US482015313002,482015313002,51287
1421,1421,48,201,531300,3,1983,1075,1983,1227,756,745,268,447,1,22,1,6,11,1473,839,634,626,247,353,1,21,1,3,8,1075,890,185,482015313003,15000US482015313003,482015313003,29330
1422,1422,48,201,531400,1,2053,1015,2053,788,1265,1240,1161,39,4,36,0,0,25,1683,547,1136,1118,1051,32,4,31,0,0,18,1015,964,51,482015314001,15000US482015314001,482015314001,52723
1423,1423,48,201,531500,1,945,421,945,355,590,583,552,13,3,13,0,2,7,767,253,514,511,486,9,3,13,0,0,3,421,401,20,482015315001,15000US482015315001,482015315001,50119
1424,1424,48,201,531500,2,655,283,655,265,390,390,364,11,2,13,0,0,0,538,200,338,338,319,5,2,12,0,0,0,283,272,11,482015315002,15000US482015315002,482015315002,87143
1425,1425,48,201,531500,3,1420,602,1420,665,755,747,527,178,1,40,0,1,8,1088,462,626,622,460,127,1,33,0,1,4,602,562,40,482015315003,15000US482015315003,482015315003,40000
1426,1426,48,201,531600,1,1473,700,1473,323,1150,1121,1043,59,4,15,0,0,29,1185,226,959,945,887,45,3,10,0,0,14,700,648,52,482015316001,15000US482015316001,482015316001,81042
1427,1427,48,201,531600,2,1350,540,1350,701,649,640,556,75,1,7,0,1,9,1033,461,572,566,492,65,1,7,0,1,6,540,508,32,482015316002,15000US482015316002,482015316002,58065
1428,1428,48,201,531700,1,1244,589,1244,196,1048,1033,964,36,6,24,0,3,15,999,143,856,846,801,19,5,20,0,1,10,589,548,41,482015317001,15000US482015317001,482015317001,73882
1429,1429,48,201,531700,2,1585,793,1585,336,1249,1232,1180,24,1,23,2,2,17,1308,246,1062,1053,1008,18,1,22,2,2,9,793,740,53,482015317002,15000US482015317002,482015317002,68200
1430,1430,48,201,531800,1,1756,634,1756,328,1428,1414,40,1365,7,0,0,2,14,1201,174,1027,1019,27,983,7,0,0,2,8,634,562,72,482015318001,15000US482015318001,482015318001,24795
1431,1431,48,201,531800,2,596,271,596,158,438,433,21,410,1,1,0,0,5,464,100,364,361,19,340,1,1,0,0,3,271,221,50,482015318002,15000US482015318002,482015318002,14904
1432,1432,48,201,531900,1,1804,600,1804,395,1409,1405,38,1360,2,4,0,1,4,1213,258,955,952,28,917,2,4,0,1,3,600,566,34,482015319001,15000US482015319001,482015319001,30304
1433,1433,48,201,531900,2,1383,438,1383,479,904,888,9,878,1,0,0,0,16,963,288,675,663,6,656,1,0,0,0,12,438,401,37,482015319002,15000US482015319002,482015319002,30000
1434,1434,48,201,531900,3,1521,586,1521,168,1353,1348,18,1316,0,14,0,0,5,1085,101,984,980,13,953,0,14,0,0,4,586,539,47,482015319003,15000US482015319003,482015319003,42625
1435,1435,48,201,532001,1,1202,839,1202,248,954,931,46,870,1,13,0,1,23,816,160,656,643,44,589,0,10,0,0,13,839,483,356,482015320011,15000US482015320011,482015320011,22868
1436,1436,48,201,532001,2,618,818,618,96,522,518,147,356,5,7,0,3,4,525,68,457,454,134,309,3,7,0,1,3,818,329,489,482015320012,15000US482015320012,482015320012,13826
1437,1437,48,201,532001,3,990,725,990,238,752,750,168,572,2,8,0,0,2,703,160,543,543,154,381,2,6,0,0,0,725,400,325,482015320013,15000US482015320013,482015320013,20076
1438,1438,48,201,532001,4,2057,1407,2057,886,1171,1152,100,1032,5,12,0,3,19,1375,559,816,804,85,702,4,10,0,3,12,1407,782,625,482015320014,15000US482015320014,482015320014,12973
1439,1439,48,201,532002,1,1008,431,1008,322,686,670,498,156,3,10,0,3,16,794,223,571,559,417,131,3,5,0,3,12,431,408,23,482015320021,15000US482015320021,482015320021,76883
1440,1440,48,201,532100,1,2275,991,2275,1349,926,912,266,585,4,57,0,0,14,1604,887,717,703,228,417,3,55,0,0,14,991,863,128,482015321001,15000US482015321001,482015321001,20132
1441,1441,48,201,532100,2,715,300,715,278,437,428,54,362,0,12,0,0,9,480,168,312,306,51,244,0,11,0,0,6,300,242,58,482015321002,15000US482015321002,482015321002,28850
1442,1442,48,201,532100,3,1438,611,1438,415,1023,1009,899,67,5,34,3,1,14,1186,292,894,885,798,48,5,31,2,1,9,611,589,22,482015321003,15000US482015321003,482015321003,63684
1443,1443,48,201,532100,4,1349,847,1349,621,728,717,106,606,1,3,0,1,11,902,404,498,493,70,418,1,3,0,1,5,847,504,343,482015321004,15000US482015321004,482015321004,21549
1444,1444,48,201,532200,1,1078,676,1078,392,686,681,54,619,1,3,0,4,5,718,269,449,445,46,394,1,3,0,1,4,676,385,291,482015322001,15000US482015322001,482015322001,35000
1445,1445,48,201,532200,2,1712,793,1712,619,1093,1075,345,707,5,17,0,1,18,1203,363,840,826,334,471,4,16,0,1,14,793,703,90,482015322002,15000US482015322002,482015322002,31125
1446,1446,48,201,532300,1,1122,478,1122,407,715,710,645,47,6,9,0,3,5,888,268,620,617,564,39,6,6,0,2,3,478,454,24,482015323001,15000US482015323001,482015323001,45833
1447,1447,48,201,532300,2,73,29,73,19,54,54,31,7,0,16,0,0,0,61,16,45,45,26,4,0,15,0,0,0,29,27,2,482015323002,15000US482015323002,482015323002,
1448,1448,48,201,532300,3,1736,884,1736,693,1043,1032,303,646,1,76,1,5,11,1248,462,786,782,272,440,1,64,1,4,4,884,728,156,482015323003,15000US482015323003,482015323003,33503
1449,1449,48,201,532300,4,2589,1445,2589,990,1599,1562,481,938,1,122,2,18,37,1983,664,1319,1293,438,736,1,103,2,13,26,1445,1280,165,482015323004,15000US482015323004,482015323004,48362
1450,1450,48,201,532400,1,1872,524,1872,1499,373,369,229,119,2,17,0,2,4,1282,967,315,313,214,86,2,10,0,1,2,524,501,23,482015324001,15000US482015324001,482015324001,58000
1451,1451,48,201,532400,2,2334,788,2334,1167,1167,1144,819,196,11,117,0,1,23,1664,744,920,903,682,127,6,88,0,0,17,788,754,34,482015324002,15000US482015324002,482015324002,69911
1452,1452,48,201,532400,3,224,76,224,124,100,100,76,22,0,0,1,1,0,164,83,81,81,67,12,0,0,1,1,0,76,74,2,482015324003,15000US482015324003,482015324003,41059
1453,1453,48,201,532501,3,674,170,674,533,141,139,90,36,2,11,0,0,2,464,352,112,111,81,21,1,8,0,0,1,170,165,5,482015325013,15000US482015325013,482015325013,48527
1454,1454,48,201,532502,1,1144,359,1144,779,365,352,249,89,1,9,0,4,13,775,464,311,298,231,59,0,7,0,1,13,359,339,20,482015325021,15000US482015325021,482015325021,46810
1455,1455,48,201,532502,2,1450,377,1450,1115,335,328,172,84,5,63,0,4,7,956,702,254,250,140,52,2,53,0,3,4,377,363,14,482015325022,15000US482015325022,482015325022,44167
1456,1456,48,201,532502,3,2968,799,2968,2382,586,575,299,233,1,36,0,6,11,1950,1492,458,453,259,160,1,30,0,3,5,799,765,34,482015325023,15000US482015325023,482015325023,42083
1457,1457,48,201,532600,1,276,131,276,222,54,54,2,46,0,3,0,3,0,176,134,42,42,2,36,0,3,0,1,0,131,82,49,482015326001,15000US482015326001,482015326001,27258
1458,1458,48,201,532600,2,1409,453,1409,632,777,763,180,555,1,25,0,2,14,1009,412,597,595,167,406,1,21,0,0,2,453,426,27,482015326002,15000US482015326002,482015326002,54519
1459,1459,48,201,532600,3,284,76,284,172,112,112,19,89,3,1,0,0,0,184,105,79,79,17,58,3,1,0,0,0,76,68,8,482015326003,15000US482015326003,482015326003,46705
1460,1460,48,201,532700,1,947,409,947,229,718,694,255,393,4,38,2,2,24,763,154,609,596,242,311,2,37,2,2,13,409,385,24,482015327001,15000US482015327001,482015327001,57165
1461,1461,48,201,532700,2,851,320,851,269,582,581,277,292,2,9,0,1,1,650,172,478,477,246,221,1,8,0,1,1,320,298,22,482015327002,15000US482015327002,482015327002,61117
1462,1462,48,201,532700,3,866,323,866,318,548,542,274,254,3,10,0,1,6,676,217,459,455,256,188,3,7,0,1,4,323,304,19,482015327003,15000US482015327003,482015327003,40605
1463,1463,48,201,532800,1,1684,718,1684,731,953,936,389,473,4,66,2,2,17,1242,484,758,748,353,336,3,53,2,1,10,718,613,105,482015328001,15000US482015328001,482015328001,44091
1464,1464,48,201,532900,1,151,104,151,112,39,39,4,35,0,0,0,0,0,87,61,26,26,4,22,0,0,0,0,0,104,46,58,482015329001,15000US482015329001,482015329001,47788
1465,1465,48,201,532900,2,262,191,262,239,23,23,3,20,0,0,0,0,0,170,152,18,18,3,15,0,0,0,0,0,191,88,103,482015329002,15000US482015329002,482015329002,49474
1466,1466,48,201,533000,1,1416,727,1416,424,992,981,22,940,8,10,0,1,11,1025,270,755,750,20,714,8,8,0,0,5,727,530,197,482015330001,15000US482015330001,482015330001,23632
1467,1467,48,201,533100,1,1828,718,1828,584,1244,1224,346,821,13,42,0,2,20,1323,371,952,940,311,584,8,36,0,1,12,718,619,99,482015331001,15000US482015331001,482015331001,49881
1468,1468,48,201,533100,2,2230,798,2230,264,1966,1957,6,1938,4,9,0,0,9,1397,148,1249,1245,6,1229,1,9,0,0,4,798,755,43,482015331002,15000US482015331002,482015331002,18734
1469,1469,48,201,533100,3,2391,796,2391,741,1650,1624,173,1404,2,43,0,2,26,1716,485,1231,1218,155,1020,2,39,0,2,13,796,762,34,482015331003,15000US482015331003,482015331003,53583
1470,1470,48,201,533200,1,931,389,931,106,825,817,3,810,2,2,0,0,8,676,56,620,613,3,606,2,2,0,0,7,389,333,56,482015332001,15000US482015332001,482015332001,30573
1471,1471,48,201,533200,2,1049,481,1049,298,751,739,40,679,7,13,0,0,12,712,192,520,513,35,466,2,10,0,0,7,481,339,142,482015332002,15000US482015332002,482015332002,23462
1472,1472,48,201,533200,3,1242,656,1242,247,995,981,139,793,0,48,0,1,14,969,170,799,791,130,615,0,46,0,0,8,656,519,137,482015332003,15000US482015332003,482015332003,31295
1473,1473,48,201,533300,1,2368,915,2368,511,1857,1833,23,1785,3,20,0,2,24,1693,335,1358,1347,18,1305,2,20,0,2,11,915,844,71,482015333001,15000US482015333001,482015333001,26276
1474,1474,48,201,533300,2,1970,735,1970,285,1685,1667,28,1636,1,0,1,1,18,1331,171,1160,1150,22,1125,1,0,1,1,10,735,674,61,482015333002,15000US482015333002,482015333002,19055
1475,1475,48,201,533300,3,651,288,651,65,586,584,3,581,0,0,0,0,2,511,46,465,464,3,461,0,0,0,0,1,288,236,52,482015333003,15000US482015333003,482015333003,32039
1476,1476,48,201,533300,4,891,375,891,52,839,834,7,813,5,5,0,4,5,712,34,678,673,7,653,5,5,0,3,5,375,336,39,482015333004,15000US482015333004,482015333004,27273
1477,1477,48,201,533400,1,1573,615,1573,138,1435,1423,15,1402,1,1,1,3,12,1183,78,1105,1100,15,1080,1,1,1,2,5,615,567,48,482015334001,15000US482015334001,482015334001,17411
1478,1478,48,201,533400,3,0,0,0,0,0,0,0,0,0,0,0,0,0,0,0,0,0,0,0,0,0,0,0,0,0,0,0,482015334003,15000US482015334003,482015334003,55515
1479,1479,48,201,533400,4,2062,597,2062,1080,982,975,65,882,1,20,0,7,7,1397,650,747,744,57,669,0,13,0,5,3,597,570,27,482015334004,15000US482015334004,482015334004,38868
1480,1480,48,201,533500,1,2069,605,2069,1372,697,674,250,301,4,118,0,1,23,1462,878,584,566,232,242,3,88,0,1,18,605,581,24,482015335001,15000US482015335001,482015335001,47188
1481,1481,48,201,533500,2,1447,410,1447,972,475,474,256,189,1,28,0,0,1,991,597,394,393,229,140,1,23,0,0,1,410,393,17,482015335002,15000US482015335002,482015335002,54444
1482,1482,48,201,533500,3,846,253,846,627,219,210,98,101,0,11,0,0,9,593,416,177,169,86,72,0,11,0,0,8,253,245,8,482015335003,15000US482015335003,482015335003,48229
1483,1483,48,201,533600,1,2,1,2,2,0,0,0,0,0,0,0,0,0,2,2,0,0,0,0,0,0,0,0,0,1,1,0,482015336001,15000US482015336001,482015336001,21422
1484,1484,48,201,533701,1,767,240,767,736,31,30,9,17,1,3,0,0,1,478,458,20,19,5,12,0,2,0,0,1,240,204,36,482015337011,15000US482015337011,482015337011,15614
1485,1485,48,201,533701,3,1663,738,1663,1411,252,243,60,143,0,36,0,4,9,1100,898,202,196,50,109,0,34,0,3,6,738,549,189,482015337013,15000US482015337013,482015337013,29157
1486,1486,48,201,533801,1,0,0,0,0,0,0,0,0,0,0,0,0,0,0,0,0,0,0,0,0,0,0,0,0,0,0,0,482015338011,15000US482015338011,482015338011,41731
1487,1487,48,201,533901,3,0,0,0,0,0,0,0,0,0,0,0,0,0,0,0,0,0,0,0,0,0,0,0,0,0,0,0,482015339013,15000US482015339013,482015339013,51462
1488,1488,48,201,533902,1,0,0,0,0,0,0,0,0,0,0,0,0,0,0,0,0,0,0,0,0,0,0,0,0,0,0,0,482015339021,15000US482015339021,482015339021,30123
1489,1489,48,201,533902,2,39,10,39,23,16,16,0,11,0,5,0,0,0,25,12,13,13,0,8,0,5,0,0,0,10,10,0,482015339022,15000US482015339022,482015339022,38375
1490,1490,48,201,534001,1,560,218,560,443,117,116,24,70,1,21,0,0,1,367,277,90,90,21,54,1,14,0,0,0,218,194,24,482015340011,15000US482015340011,482015340011,29620
1491,1491,48,201,534002,1,149,43,149,76,73,71,4,67,0,0,0,0,2,95,44,51,50,4,46,0,0,0,0,1,43,41,2,482015340021,15000US482015340021,482015340021,54444
1492,1492,48,201,534002,2,0,0,0,0,0,0,0,0,0,0,0,0,0,0,0,0,0,0,0,0,0,0,0,0,0,0,0,482015340022,15000US482015340022,482015340022,49245
1493,1493,48,201,534003,1,428,148,428,297,131,127,18,89,0,20,0,0,4,278,182,96,94,18,60,0,16,0,0,2,148,140,8,482015340031,15000US482015340031,482015340031,61337
1494,1494,48,201,534203,1,0,0,0,0,0,0,0,0,0,0,0,0,0,0,0,0,0,0,0,0,0,0,0,0,0,0,0,482015342031,15000US482015342031,482015342031,41901
1495,1495,48,201,540100,1,60,22,60,12,48,44,14,4,0,26,0,0,4,42,8,34,32,12,4,0,16,0,0,2,22,22,0,482015401001,15000US482015401001,482015401001,131271
1496,1496,48,201,540100,2,0,0,0,0,0,0,0,0,0,0,0,0,0,0,0,0,0,0,0,0,0,0,0,0,0,0,0,482015401002,15000US482015401002,482015401002,140833
1497,1497,48,201,540100,3,0,0,0,0,0,0,0,0,0,0,0,0,0,0,0,0,0,0,0,0,0,0,0,0,0,0,0,482015401003,15000US482015401003,482015401003,61155
1498,1498,48,201,540200,1,2654,1006,2654,1597,1057,1039,596,170,5,260,5,3,18,1960,1085,875,862,510,129,5,213,5,0,13,1006,938,68,482015402001,15000US482015402001,482015402001,46661
1499,1499,48,201,540501,1,461,188,461,355,106,102,45,40,0,16,0,1,4,287,211,76,74,37,27,0,10,0,0,2,188,147,41,482015405011,15000US482015405011,482015405011,37827
1500,1500,48,201,540501,2,0,0,0,0,0,0,0,0,0,0,0,0,0,0,0,0,0,0,0,0,0,0,0,0,0,0,0,482015405012,15000US482015405012,482015405012,30659
1501,1501,48,201,540501,3,0,0,0,0,0,0,0,0,0,0,0,0,0,0,0,0,0,0,0,0,0,0,0,0,0,0,0,482015405013,15000US482015405013,482015405013,35506
1502,1502,48,201,540502,1,0,0,0,0,0,0,0,0,0,0,0,0,0,0,0,0,0,0,0,0,0,0,0,0,0,0,0,482015405021,15000US482015405021,482015405021,67697
1503,1503,48,201,540502,2,18,7,18,5,13,13,12,1,0,0,0,0,0,16,5,11,11,10,1,0,0,0,0,0,7,7,0,482015405022,15000US482015405022,482015405022,94583
1504,1504,48,201,540601,1,45,15,45,9,36,36,23,13,0,0,0,0,0,34,7,27,27,19,8,0,0,0,0,0,15,15,0,482015406011,15000US482015406011,482015406011,91940
1505,1505,48,201,540601,2,0,0,0,0,0,0,0,0,0,0,0,0,0,0,0,0,0,0,0,0,0,0,0,0,0,0,0,482015406012,15000US482015406012,482015406012,51957
1506,1506,48,201,540602,1,138,48,138,75,63,60,21,31,2,6,0,0,3,86,50,36,36,11,18,2,5,0,0,0,48,39,9,482015406021,15000US482015406021,482015406021,57338
1507,1507,48,201,540700,1,0,0,0,0,0,0,0,0,0,0,0,0,0,0,0,0,0,0,0,0,0,0,0,0,0,0,0,482015407001,15000US482015407001,482015407001,147417
1508,1508,48,201,540700,2,2,2,2,2,0,0,0,0,0,0,0,0,0,2,2,0,0,0,0,0,0,0,0,0,2,2,0,482015407002,15000US482015407002,482015407002,53470
1509,1509,48,201,540700,3,46,18,46,3,43,43,20,14,0,9,0,0,0,40,3,37,37,17,11,0,9,0,0,0,18,17,1,482015407003,15000US482015407003,482015407003,75625
1510,1510,48,201,540800,1,0,0,0,0,0,0,0,0,0,0,0,0,0,0,0,0,0,0,0,0,0,0,0,0,0,0,0,482015408001,15000US482015408001,482015408001,47019
1511,1511,48,201,540800,2,0,0,0,0,0,0,0,0,0,0,0,0,0,0,0,0,0,0,0,0,0,0,0,0,0,0,0,482015408002,15000US482015408002,482015408002,63476
1512,1512,48,201,540800,3,0,0,0,0,0,0,0,0,0,0,0,0,0,0,0,0,0,0,0,0,0,0,0,0,0,0,0,482015408003,15000US482015408003,482015408003,62105
1513,1513,48,201,540901,1,2,2,2,0,2,2,0,1,1,0,0,0,0,2,0,2,2,0,1,1,0,0,0,0,2,2,0,482015409011,15000US482015409011,482015409011,106250
1514,1514,48,201,540902,2,0,0,0,0,0,0,0,0,0,0,0,0,0,0,0,0,0,0,0,0,0,0,0,0,0,0,0,482015409022,15000US482015409022,482015409022,52583
1515,1515,48,201,540902,3,0,0,0,0,0,0,0,0,0,0,0,0,0,0,0,0,0,0,0,0,0,0,0,0,0,0,0,482015409023,15000US482015409023,482015409023,109542
1516,1516,48,201,541001,1,554,291,554,92,462,457,266,138,5,48,0,0,5,433,63,370,367,222,104,5,36,0,0,3,291,281,10,482015410011,15000US482015410011,482015410011,85233
1517,1517,48,201,541002,2,0,0,0,0,0,0,0,0,0,0,0,0,0,0,0,0,0,0,0,0,0,0,0,0,0,0,0,482015410022,15000US482015410022,482015410022,140655
1518,1518,48,201,541203,1,0,0,0,0,0,0,0,0,0,0,0,0,0,0,0,0,0,0,0,0,0,0,0,0,0,0,0,482015412031,15000US482015412031,482015412031,109808
1519,1519,48,201,541300,2,656,184,656,346,310,306,50,109,1,136,0,10,4,431,223,208,205,39,63,1,97,0,5,3,184,178,6,482015413002,15000US482015413002,482015413002,38382
1520,1520,48,201,541300,3,544,144,544,268,276,266,92,101,0,73,0,0,10,329,153,176,171,62,57,0,52,0,0,5,144,141,3,482015413003,15000US482015413003,482015413003,56816
1521,1521,48,201,541400,1,2886,1191,2886,1216,1670,1634,849,464,8,311,2,0,36,2043,779,1264,1245,679,333,5,226,2,0,19,1191,999,192,482015414001,15000US482015414001,482015414001,69241
1522,1522,48,201,541601,1,0,0,0,0,0,0,0,0,0,0,0,0,0,0,0,0,0,0,0,0,0,0,0,0,0,0,0,482015416011,15000US482015416011,482015416011,87031
1523,1523,48,201,541602,1,0,0,0,0,0,0,0,0,0,0,0,0,0,0,0,0,0,0,0,0,0,0,0,0,0,0,0,482015416021,15000US482015416021,482015416021,26870
1524,1524,48,201,541602,4,0,0,0,0,0,0,0,0,0,0,0,0,0,0,0,0,0,0,0,0,0,0,0,0,0,0,0,482015416024,15000US482015416024,482015416024,67604
1525,1525,48,201,541700,1,2455,1222,2455,860,1595,1523,883,541,6,85,0,8,72,1812,566,1246,1200,740,379,6,70,0,5,46,1222,1113,109,482015417001,15000US482015417001,482015417001,50481
1526,1526,48,201,541700,2,421,209,421,292,129,128,56,52,0,16,0,4,1,312,209,103,103,50,40,0,10,0,3,0,209,188,21,482015417002,15000US482015417002,482015417002,57394
1527,1527,48,201,541700,3,2172,1356,2172,493,1679,1630,857,490,2,268,7,6,49,1816,379,1437,1405,768,407,2,218,6,4,32,1356,1185,171,482015417003,15000US482015417003,482015417003,61397
1528,1528,48,201,541800,1,2220,1115,2220,632,1588,1534,944,365,11,205,1,8,54,1699,429,1270,1236,802,267,9,151,1,6,34,1115,978,137,482015418001,15000US482015418001,482015418001,56838
1529,1529,48,201,541800,2,0,0,0,0,0,0,0,0,0,0,0,0,0,0,0,0,0,0,0,0,0,0,0,0,0,0,0,482015418002,15000US482015418002,482015418002,52601
1530,1530,48,201,541900,1,0,0,0,0,0,0,0,0,0,0,0,0,0,0,0,0,0,0,0,0,0,0,0,0,0,0,0,482015419001,15000US482015419001,482015419001,62083
1531,1531,48,201,541900,2,0,0,0,0,0,0,0,0,0,0,0,0,0,0,0,0,0,0,0,0,0,0,0,0,0,0,0,482015419002,15000US482015419002,482015419002,93833
1532,1532,48,201,542000,1,0,0,0,0,0,0,0,0,0,0,0,0,0,0,0,0,0,0,0,0,0,0,0,0,0,0,0,482015420001,15000US482015420001,482015420001,73212
1533,1533,48,201,542000,3,3,1,3,0,3,3,0,0,0,3,0,0,0,3,0,3,3,0,0,0,3,0,0,0,1,1,0,482015420003,15000US482015420003,482015420003,56985
1534,1534,48,201,542101,2,0,0,0,0,0,0,0,0,0,0,0,0,0,0,0,0,0,0,0,0,0,0,0,0,0,0,0,482015421012,15000US482015421012,482015421012,64167
1535,1535,48,201,542200,1,0,0,0,0,0,0,0,0,0,0,0,0,0,0,0,0,0,0,0,0,0,0,0,0,0,0,0,482015422001,15000US482015422001,482015422001,56591
1536,1536,48,201,542301,2,0,0,0,0,0,0,0,0,0,0,0,0,0,0,0,0,0,0,0,0,0,0,0,0,0,0,0,482015423012,15000US482015423012,482015423012,61232
1537,1537,48,201,542301,3,0,0,0,0,0,0,0,0,0,0,0,0,0,0,0,0,0,0,0,0,0,0,0,0,0,0,0,482015423013,15000US482015423013,482015423013,80000
1538,1538,48,201,542302,1,0,0,0,0,0,0,0,0,0,0,0,0,0,0,0,0,0,0,0,0,0,0,0,0,0,0,0,482015423021,15000US482015423021,482015423021,56641
1539,1539,48,201,542400,1,723,252,723,287,436,426,108,276,0,42,0,0,10,402,155,247,241,66,150,0,25,0,0,6,252,241,11,482015424001,15000US482015424001,482015424001,46067
1540,1540,48,201,542400,2,3,1,3,3,0,0,0,0,0,0,0,0,0,3,3,0,0,0,0,0,0,0,0,0,1,1,0,482015424002,15000US482015424002,482015424002,48017
1541,1541,48,201,542400,3,0,0,0,0,0,0,0,0,0,0,0,0,0,0,0,0,0,0,0,0,0,0,0,0,0,0,0,482015424003,15000US482015424003,482015424003,32111
1542,1542,48,201,542500,1,16,7,16,2,14,13,8,3,0,2,0,0,1,12,2,10,10,7,3,0,0,0,0,0,7,6,1,482015425001,15000US482015425001,482015425001,84576
1543,1543,48,201,542600,1,5,1,5,0,5,0,0,0,0,0,0,0,5,4,0,4,0,0,0,0,0,0,0,4,1,1,0,482015426001,15000US482015426001,482015426001,86169
1544,1544,48,201,542900,3,0,0,0,0,0,0,0,0,0,0,0,0,0,0,0,0,0,0,0,0,0,0,0,0,0,0,0,482015429003,15000US482015429003,482015429003,64844
1545,1545,48,201,543001,1,0,1,0,0,0,0,0,0,0,0,0,0,0,0,0,0,0,0,0,0,0,0,0,0,1,0,1,482015430011,15000US482015430011,482015430011,96618
1546,1546,48,201,543002,2,106,92,106,11,95,93,50,22,0,19,0,2,2,64,8,56,56,32,13,0,9,0,2,0,92,30,62,482015430022,15000US482015430022,482015430022,92813
1547,1547,48,201,543100,1,0,0,0,0,0,0,0,0,0,0,0,0,0,0,0,0,0,0,0,0,0,0,0,0,0,0,0,482015431001,15000US482015431001,482015431001,68194
1548,1548,48,201,543200,1,2579,1081,2579,1005,1574,1553,1194,204,2,147,1,5,21,1917,650,1267,1256,1006,129,2,116,1,2,11,1081,965,116,482015432001,15000US482015432001,482015432001,46182
1549,1549,48,201,543200,2,1746,982,1746,336,1410,1388,777,116,3,491,1,0,22,1455,271,1184,1166,660,90,3,412,1,0,18,982,849,133,482015432002,15000US482015432002,482015432002,52377
1550,1550,48,201,543200,3,1599,713,1599,860,739,714,507,159,0,47,0,1,25,1113,539,574,564,435,87,0,41,0,1,10,713,509,204,482015432003,15000US482015432003,482015432003,37120
1551,1551,48,201,550100,1,2011,1103,2011,503,1508,1464,56,1379,4,21,0,4,44,1285,306,979,945,49,875,4,14,0,3,34,1103,798,305,482015501001,15000US482015501001,482015501001,19115
1552,1552,48,201,550100,2,1894,880,1894,1201,693,674,31,619,0,19,2,3,19,1182,741,441,434,21,395,0,16,2,0,7,880,667,213,482015501002,15000US482015501002,482015501002,30568
1553,1553,48,201,550200,1,2168,1006,2168,793,1375,1331,85,1223,2,15,1,5,44,1452,505,947,923,71,835,2,11,1,3,24,1006,868,138,482015502001,15000US482015502001,482015502001,22813
1554,1554,48,201,550200,2,1557,818,1557,471,1086,1047,62,970,2,13,0,0,39,982,288,694,666,49,605,1,11,0,0,28,818,600,218,482015502002,15000US482015502002,482015502002,12135
1555,1555,48,201,550301,1,323,226,323,58,265,258,15,240,0,2,0,1,7,243,42,201,195,15,177,0,2,0,1,6,226,174,52,482015503011,15000US482015503011,482015503011,34011
1556,1556,48,201,550301,3,5,2,5,0,5,5,0,5,0,0,0,0,0,5,0,5,5,0,5,0,0,0,0,0,2,2,0,482015503013,15000US482015503013,482015503013,23864
1557,1557,48,201,550302,1,4,2,4,4,0,0,0,0,0,0,0,0,0,3,3,0,0,0,0,0,0,0,0,0,2,2,0,482015503021,15000US482015503021,482015503021,60682
1558,1558,48,201,550302,3,688,258,688,472,216,210,53,119,0,36,0,2,6,470,307,163,161,37,92,0,30,0,2,2,258,228,30,482015503023,15000US482015503023,482015503023,27000
1559,1559,48,201,550302,4,6,6,6,1,5,5,1,4,0,0,0,0,0,4,1,3,3,1,2,0,0,0,0,0,6,4,2,482015503024,15000US482015503024,482015503024,55887
1560,1560,48,201,550401,1,455,289,455,206,249,238,30,194,0,13,1,0,11,337,152,185,177,25,141,0,11,0,0,8,289,203,86,482015504011,15000US482015504011,482015504011,32757
1561,1561,48,201,550402,1,128,159,128,39,89,89,16,72,0,1,0,0,0,88,24,64,64,14,49,0,1,0,0,0,159,58,101,482015504021,15000US482015504021,482015504021,51414
1562,1562,48,201,550402,2,690,410,690,176,514,501,78,382,0,39,0,2,13,533,123,410,401,70,298,0,31,0,2,9,410,340,70,482015504022,15000US482015504022,482015504022,24007
1563,1563,48,201,550500,2,982,600,982,338,644,633,74,477,0,77,1,4,11,785,256,529,519,71,383,0,64,1,0,10,600,542,58,482015505002,15000US482015505002,482015505002,41684
1564,1564,48,201,550603,1,0,0,0,0,0,0,0,0,0,0,0,0,0,0,0,0,0,0,0,0,0,0,0,0,0,0,0,482015506031,15000US482015506031,482015506031,43362
1565,1565,48,201,550603,2,0,0,0,0,0,0,0,0,0,0,0,0,0,0,0,0,0,0,0,0,0,0,0,0,0,0,0,482015506032,15000US482015506032,482015506032,22744
1566,1566,48,201,550603,3,0,0,0,0,0,0,0,0,0,0,0,0,0,0,0,0,0,0,0,0,0,0,0,0,0,0,0,482015506033,15000US482015506033,482015506033,61910
1567,1567,48,201,550700,1,0,0,0,0,0,0,0,0,0,0,0,0,0,0,0,0,0,0,0,0,0,0,0,0,0,0,0,482015507001,15000US482015507001,482015507001,74792
1568,1568,48,201,550800,1,0,0,0,0,0,0,0,0,0,0,0,0,0,0,0,0,0,0,0,0,0,0,0,0,0,0,0,482015508001,15000US482015508001,482015508001,61510
1569,1569,48,201,550800,2,0,0,0,0,0,0,0,0,0,0,0,0,0,0,0,0,0,0,0,0,0,0,0,0,0,0,0,482015508002,15000US482015508002,482015508002,41452
1570,1570,48,201,550900,2,19,5,19,4,15,14,0,0,0,14,0,0,1,13,3,10,10,0,0,0,10,0,0,0,5,4,1,482015509002,15000US482015509002,482015509002,41922
1571,1571,48,201,550900,3,7,7,7,2,5,5,5,0,0,0,0,0,0,7,2,5,5,5,0,0,0,0,0,0,7,5,2,482015509003,15000US482015509003,482015509003,34229
1572,1572,48,201,551000,1,176,52,176,142,34,34,3,28,0,2,0,1,0,107,83,24,24,3,18,0,2,0,1,0,52,45,7,482015510001,15000US482015510001,482015510001,40354
1573,1573,48,201,551100,2,0,0,0,0,0,0,0,0,0,0,0,0,0,0,0,0,0,0,0,0,0,0,0,0,0,0,0,482015511002,15000US482015511002,482015511002,29500
1574,1574,48,201,551100,3,45,15,45,0,45,45,11,29,0,0,5,0,0,24,0,24,24,6,15,0,0,3,0,0,15,13,2,482015511003,15000US482015511003,482015511003,45967
1575,1575,48,201,551100,4,0,0,0,0,0,0,0,0,0,0,0,0,0,0,0,0,0,0,0,0,0,0,0,0,0,0,0,482015511004,15000US482015511004,482015511004,79535
1576,1576,48,201,551200,1,4,3,4,0,4,4,0,1,0,3,0,0,0,4,0,4,4,0,1,0,3,0,0,0,3,3,0,482015512001,15000US482015512001,482015512001,46754
1577,1577,48,201,551200,2,0,0,0,0,0,0,0,0,0,0,0,0,0,0,0,0,0,0,0,0,0,0,0,0,0,0,0,482015512002,15000US482015512002,482015512002,82219
1578,1578,48,201,551200,4,0,0,0,0,0,0,0,0,0,0,0,0,0,0,0,0,0,0,0,0,0,0,0,0,0,0,0,482015512004,15000US482015512004,482015512004,38370
1579,1579,48,201,551400,1,380,189,380,198,182,179,77,89,1,12,0,0,3,277,140,137,135,59,67,1,8,0,0,2,189,168,21,482015514001,15000US482015514001,482015514001,57181
1580,1580,48,201,551400,3,369,266,369,144,225,218,80,107,0,30,0,1,7,305,109,196,190,70,91,0,28,0,1,6,266,204,62,482015514003,15000US482015514003,482015514003,46169
1581,1581,48,201,551500,1,1091,708,1091,286,805,780,366,257,2,154,0,1,25,943,232,711,694,348,217,2,127,0,0,17,708,636,72,482015515001,15000US482015515001,482015515001,61271
1582,1582,48,201,551500,2,845,322,845,132,713,690,72,489,2,126,0,1,23,492,85,407,401,60,248,1,91,0,1,6,322,259,63,482015515002,15000US482015515002,482015515002,50750
1583,1583,48,201,551600,1,4,1,4,0,4,4,0,0,0,4,0,0,0,4,0,4,4,0,0,0,4,0,0,0,1,1,0,482015516001,15000US482015516001,482015516001,36680
1584,1584,48,201,551600,2,5,2,5,5,0,0,0,0,0,0,0,0,0,2,2,0,0,0,0,0,0,0,0,0,2,1,1,482015516002,15000US482015516002,482015516002,53073
1585,1585,48,201,551600,3,0,0,0,0,0,0,0,0,0,0,0,0,0,0,0,0,0,0,0,0,0,0,0,0,0,0,0,482015516003,15000US482015516003,482015516003,59013
1586,1586,48,201,551800,1,0,0,0,0,0,0,0,0,0,0,0,0,0,0,0,0,0,0,0,0,0,0,0,0,0,0,0,482015518001,15000US482015518001,482015518001,120625
1587,1587,48,201,552001,1,2,2,2,0,2,2,0,1,0,1,0,0,0,2,0,2,2,0,1,0,1,0,0,0,2,2,0,482015520011,15000US482015520011,482015520011,72559
1588,1588,48,201,552002,1,561,290,561,150,411,400,264,105,3,28,0,0,11,425,94,331,325,216,85,3,21,0,0,6,290,268,22,482015520021,15000US482015520021,482015520021,67071
1589,1589,48,201,552101,1,577,312,577,140,437,416,144,244,0,28,0,0,21,418,87,331,320,119,183,0,18,0,0,11,312,246,66,482015521011,15000US482015521011,482015521011,53333
1590,1590,48,201,552103,1,1,1,1,0,1,1,1,0,0,0,0,0,0,1,0,1,1,1,0,0,0,0,0,0,1,1,0,482015521031,15000US482015521031,482015521031,62442
1591,1591,48,201,552103,2,0,0,0,0,0,0,0,0,0,0,0,0,0,0,0,0,0,0,0,0,0,0,0,0,0,0,0,482015521032,15000US482015521032,482015521032,61633
1592,1592,48,201,552200,1,2,1,2,2,0,0,0,0,0,0,0,0,0,1,1,0,0,0,0,0,0,0,0,0,1,1,0,482015522001,15000US482015522001,482015522001,74318
1593,1593,48,201,552200,2,3,1,3,0,3,3,3,0,0,0,0,0,0,3,0,3,3,3,0,0,0,0,0,0,1,1,0,482015522002,15000US482015522002,482015522002,45588
1594,1594,48,201,552200,3,5,2,5,5,0,0,0,0,0,0,0,0,0,3,3,0,0,0,0,0,0,0,0,0,2,2,0,482015522003,15000US482015522003,482015522003,46838
1595,1595,48,201,552301,1,14,17,14,0,14,13,13,0,0,0,0,0,1,13,0,13,13,13,0,0,0,0,0,0,17,10,7,482015523011,15000US482015523011,482015523011,59107
1596,1596,48,201,552400,1,0,0,0,0,0,0,0,0,0,0,0,0,0,0,0,0,0,0,0,0,0,0,0,0,0,0,0,482015524001,15000US482015524001,482015524001,54750
1597,1597,48,201,552400,2,12,7,12,1,11,11,6,2,0,3,0,0,0,10,1,9,9,5,2,0,2,0,0,0,7,5,2,482015524002,15000US482015524002,482015524002,89769
1598,1598,48,201,552400,3,1049,400,1049,348,701,645,181,415,0,47,2,0,56,634,186,448,430,137,256,0,35,2,0,18,400,378,22,482015524003,15000US482015524003,482015524003,36623
1599,1599,48,201,552500,1,0,0,0,0,0,0,0,0,0,0,0,0,0,0,0,0,0,0,0,0,0,0,0,0,0,0,0,482015525001,15000US482015525001,482015525001,61500
1600,1600,48,201,552500,2,3,1,3,0,3,3,0,0,0,3,0,0,0,3,0,3,3,0,0,0,3,0,0,0,1,1,0,482015525002,15000US482015525002,482015525002,56976
1601,1601,48,201,552601,1,2685,1311,2685,1022,1663,1601,645,835,6,108,6,1,62,1967,704,1263,1229,564,566,6,87,5,1,34,1311,1190,121,482015526011,15000US482015526011,482015526011,32156
1602,1602,48,201,552602,1,26,17,26,1,25,25,19,3,0,3,0,0,0,22,1,21,21,15,3,0,3,0,0,0,17,17,0,482015526021,15000US482015526021,482015526021,74792
1603,1603,48,201,552700,1,312,160,312,164,148,144,68,60,0,15,0,1,4,206,96,110,108,58,36,0,13,0,1,2,160,121,39,482015527001,15000US482015527001,482015527001,63077
1604,1604,48,201,552700,2,2174,1726,2174,370,1804,1780,992,366,9,411,0,2,24,1863,284,1579,1564,947,283,6,326,0,2,15,1726,1385,341,482015527002,15000US482015527002,482015527002,32078
1605,1605,48,201,552700,3,0,0,0,0,0,0,0,0,0,0,0,0,0,0,0,0,0,0,0,0,0,0,0,0,0,0,0,482015527003,15000US482015527003,482015527003,66250
1606,1606,48,201,552800,2,0,0,0,0,0,0,0,0,0,0,0,0,0,0,0,0,0,0,0,0,0,0,0,0,0,0,0,482015528002,15000US482015528002,482015528002,102750
1607,1607,48,201,552800,3,509,275,509,93,416,393,194,167,1,31,0,0,23,379,66,313,298,161,110,1,26,0,0,15,275,240,35,482015528003,15000US482015528003,482015528003,60972
1608,1608,48,201,552800,5,0,0,0,0,0,0,0,0,0,0,0,0,0,0,0,0,0,0,0,0,0,0,0,0,0,0,0,482015528005,15000US482015528005,482015528005,71518
1609,1609,48,201,552900,2,0,0,0,0,0,0,0,0,0,0,0,0,0,0,0,0,0,0,0,0,0,0,0,0,0,0,0,482015529002,15000US482015529002,482015529002,45313
1610,1610,48,201,552900,3,0,0,0,0,0,0,0,0,0,0,0,0,0,0,0,0,0,0,0,0,0,0,0,0,0,0,0,482015529003,15000US482015529003,482015529003,48568
1611,1611,48,201,552900,4,329,288,329,89,240,235,124,100,1,9,0,1,5,263,65,198,195,109,76,1,9,0,0,3,288,178,110,482015529004,15000US482015529004,482015529004,59423
1612,1612,48,201,553001,2,3,6,3,1,2,2,2,0,0,0,0,0,0,3,1,2,2,2,0,0,0,0,0,0,6,2,4,482015530012,15000US482015530012,482015530012,89861
1613,1613,48,201,553001,3,456,230,456,93,363,359,73,217,0,68,0,1,4,339,67,272,269,62,151,0,55,0,1,3,230,207,23,482015530013,15000US482015530013,482015530013,70590
1614,1614,48,201,553002,1,108,46,108,12,96,95,71,5,0,19,0,0,1,95,7,88,88,67,5,0,16,0,0,0,46,43,3,482015530021,15000US482015530021,482015530021,26875
1615,1615,48,201,553002,2,25,12,25,0,25,25,23,0,1,1,0,0,0,24,0,24,24,22,0,1,1,0,0,0,12,12,0,482015530022,15000US482015530022,482015530022,98902
1616,1616,48,201,553100,2,0,0,0,0,0,0,0,0,0,0,0,0,0,0,0,0,0,0,0,0,0,0,0,0,0,0,0,482015531002,15000US482015531002,482015531002,44939
1617,1617,48,201,553100,3,6,2,6,5,1,1,1,0,0,0,0,0,0,6,5,1,1,1,0,0,0,0,0,0,2,2,0,482015531003,15000US482015531003,482015531003,65192
1618,1618,48,201,553100,4,0,0,0,0,0,0,0,0,0,0,0,0,0,0,0,0,0,0,0,0,0,0,0,0,0,0,0,482015531004,15000US482015531004,482015531004,50292
1619,1619,48,201,553200,1,0,0,0,0,0,0,0,0,0,0,0,0,0,0,0,0,0,0,0,0,0,0,0,0,0,0,0,482015532001,15000US482015532001,482015532001,68269
1620,1620,48,201,553200,2,12,5,12,4,8,8,8,0,0,0,0,0,0,9,2,7,7,7,0,0,0,0,0,0,5,5,0,482015532002,15000US482015532002,482015532002,24298
1621,1621,48,201,553200,3,416,135,416,69,347,341,72,263,0,2,4,0,6,323,52,271,268,69,195,0,2,2,0,3,135,122,13,482015532003,15000US482015532003,482015532003,25797
1622,1622,48,201,553200,4,529,171,529,447,82,78,44,28,0,3,2,1,4,363,304,59,57,31,22,0,2,2,0,2,171,163,8,482015532004,15000US482015532004,482015532004,37396
1623,1623,48,201,553300,1,0,0,0,0,0,0,0,0,0,0,0,0,0,0,0,0,0,0,0,0,0,0,0,0,0,0,0,482015533001,15000US482015533001,482015533001,25195
1624,1624,48,201,553300,2,1689,1088,1689,370,1319,1284,494,715,5,68,1,1,35,1407,284,1123,1103,462,578,4,57,1,1,20,1088,905,183,482015533002,15000US482015533002,482015533002,41964
1625,1625,48,201,553401,1,30,16,30,9,21,21,15,2,0,4,0,0,0,24,5,19,19,13,2,0,4,0,0,0,16,12,4,482015534011,15000US482015534011,482015534011,85398
1626,1626,48,201,553402,1,0,0,0,0,0,0,0,0,0,0,0,0,0,0,0,0,0,0,0,0,0,0,0,0,0,0,0,482015534021,15000US482015534021,482015534021,57463
1627,1627,48,201,553403,1,3,1,3,3,0,0,0,0,0,0,0,0,0,2,2,0,0,0,0,0,0,0,0,0,1,1,0,482015534031,15000US482015534031,482015534031,93424
1628,1628,48,201,554200,1,20,5,20,6,14,14,9,5,0,0,0,0,0,14,5,9,9,6,3,0,0,0,0,0,5,5,0,482015542001,15000US482015542001,482015542001,65893
1629,1629,48,201,554301,2,0,0,0,0,0,0,0,0,0,0,0,0,0,0,0,0,0,0,0,0,0,0,0,0,0,0,0,482015543012,15000US482015543012,482015543012,111786
1630,1630,48,201,554301,3,0,0,0,0,0,0,0,0,0,0,0,0,0,0,0,0,0,0,0,0,0,0,0,0,0,0,0,482015543013,15000US482015543013,482015543013,103333
1631,1631,48,201,554401,2,0,0,0,0,0,0,0,0,0,0,0,0,0,0,0,0,0,0,0,0,0,0,0,0,0,0,0,482015544012,15000US482015544012,482015544012,120305
1632,1632,48,201,554402,2,23,8,23,5,18,18,16,0,0,2,0,0,0,20,4,16,16,14,0,0,2,0,0,0,8,8,0,482015544022,15000US482015544022,482015544022,94369
1633,1633,48,201,554403,1,3,3,3,0,3,3,3,0,0,0,0,0,0,3,0,3,3,3,0,0,0,0,0,0,3,2,1,482015544031,15000US482015544031,482015544031,90050
1634,1634,48,201,554502,2,0,0,0,0,0,0,0,0,0,0,0,0,0,0,0,0,0,0,0,0,0,0,0,0,0,0,0,482015545022,15000US482015545022,482015545022,137841
1635,1635,48,201,554600,1,0,0,0,0,0,0,0,0,0,0,0,0,0,0,0,0,0,0,0,0,0,0,0,0,0,0,0,482015546001,15000US482015546001,482015546001,106771
1636,1636,48,201,554600,2,0,1,0,0,0,0,0,0,0,0,0,0,0,0,0,0,0,0,0,0,0,0,0,0,1,0,1,482015546002,15000US482015546002,482015546002,119250
1637,1637,48,201,554700,1,0,0,0,0,0,0,0,0,0,0,0,0,0,0,0,0,0,0,0,0,0,0,0,0,0,0,0,482015547001,15000US482015547001,482015547001,61532
1638,1638,48,201,554700,2,2,1,2,0,2,0,0,0,0,0,0,0,2,2,0,2,0,0,0,0,0,0,0,2,1,1,0,482015547002,15000US482015547002,482015547002,121288
1639,1639,48,201,554801,1,0,0,0,0,0,0,0,0,0,0,0,0,0,0,0,0,0,0,0,0,0,0,0,0,0,0,0,482015548011,15000US482015548011,482015548011,65887
1640,1640,48,201,554802,1,0,0,0,0,0,0,0,0,0,0,0,0,0,0,0,0,0,0,0,0,0,0,0,0,0,0,0,482015548021,15000US482015548021,482015548021,100795
1641,1641,48,201,554901,1,0,0,0,0,0,0,0,0,0,0,0,0,0,0,0,0,0,0,0,0,0,0,0,0,0,0,0,482015549011,15000US482015549011,482015549011,67383
1642,1642,48,201,554901,2,0,0,0,0,0,0,0,0,0,0,0,0,0,0,0,0,0,0,0,0,0,0,0,0,0,0,0,482015549012,15000US482015549012,482015549012,72727
1643,1643,48,201,555502,1,0,0,0,0,0,0,0,0,0,0,0,0,0,0,0,0,0,0,0,0,0,0,0,0,0,0,0,482015555021,15000US482015555021,482015555021,88411
1644,1644,48,201,555502,2,6,3,6,0,6,6,6,0,0,0,0,0,0,5,0,5,5,5,0,0,0,0,0,0,3,3,0,482015555022,15000US482015555022,482015555022,102500
1645,1645,48,201,555600,1,0,0,0,0,0,0,0,0,0,0,0,0,0,0,0,0,0,0,0,0,0,0,0,0,0,0,0,482015556001,15000US482015556001,482015556001,81445
1646,1646,48,201,555701,1,4,1,4,0,4,4,0,4,0,0,0,0,0,3,0,3,3,0,3,0,0,0,0,0,1,1,0,482015557011,15000US482015557011,482015557011,117159
1647,1647,48,201,555701,2,0,0,0,0,0,0,0,0,0,0,0,0,0,0,0,0,0,0,0,0,0,0,0,0,0,0,0,482015557012,15000US482015557012,482015557012,94608
1648,1648,48,201,555702,1,0,0,0,0,0,0,0,0,0,0,0,0,0,0,0,0,0,0,0,0,0,0,0,0,0,0,0,482015557021,15000US482015557021,482015557021,112625
1649,1649,48,201,556000,1,0,0,0,0,0,0,0,0,0,0,0,0,0,0,0,0,0,0,0,0,0,0,0,0,0,0,0,482015560001,15000US482015560001,482015560001,59086
1650,1650,48,201,556000,2,0,0,0,0,0,0,0,0,0,0,0,0,0,0,0,0,0,0,0,0,0,0,0,0,0,0,0,482015560002,15000US482015560002,482015560002,56188
1651,1651,48,201,556000,3,0,0,0,0,0,0,0,0,0,0,0,0,0,0,0,0,0,0,0,0,0,0,0,0,0,0,0,482015560003,15000US482015560003,482015560003,50943
1652,1652,48,201,980000,1,33,17,33,9,24,23,11,12,0,0,0,0,1,24,4,20,19,11,8,0,0,0,0,1,17,15,2,482019800001,15000US482019800001,482019800001,14773
1653,1653,48,201,980100,1,603,254,603,157,446,439,53,373,2,7,4,0,7,351,89,262,258,40,207,2,6,3,0,4,254,224,30,482019801001,15000US482019801001,482019801001,18911
1654,1654,48,339,692002,1,0,0,0,0,0,0,0,0,0,0,0,0,0,0,0,0,0,0,0,0,0,0,0,0,0,0,0,483396920021,15000US483396920021,483396920021,172955
1655,1655,48,339,692300,4,2261,1318,2261,416,1845,1801,1310,338,19,124,8,2,44,1946,325,1621,1588,1184,271,14,111,6,2,33,1318,1185,133,483396923004,15000US483396923004,483396923004,65405
1656,1656,48,339,692300,5,18,13,18,2,16,16,16,0,0,0,0,0,0,16,1,15,15,15,0,0,0,0,0,0,13,8,5,483396923005,15000US483396923005,483396923005,75478
1657,1657,48,339,692400,3,1768,1318,1768,206,1562,1541,1329,121,13,74,0,4,21,1586,158,1428,1411,1234,100,10,63,0,4,17,1318,1185,133,483396924003,15000US483396924003,483396924003,48668
